!	PUNCT
!!!	PUNCT
"	PUNCT
%	SYM
(	PUNCT
)	PUNCT
,	PUNCT
-	PUNCT
.	PUNCT
...	PUNCT
000	NUM
02	NUM
04	NUM
1	NUM
10	NUM
100	NUM
1062	NUM
109	NUM
109-й	ADJ
111-й	ADJ
112	NUM
12	NUM
120	NUM
124	NUM
129	NUM
13	NUM
14	NUM
1460	NUM
16	NUM
1675	NUM
1687	NUM
17	NUM
1700	NUM
1732	NUM
1735	NUM
1749	NUM
1766	NUM
1775	NUM
1785	NUM
1787	NUM
1788	NUM
1789	NUM
1792	NUM
1795	NUM
1796	NUM
1799	NUM
1800	NUM
1801	NUM
1805	NUM
1811	NUM
1818	NUM
1819	NUM
1820	NUM
1826	NUM
1833	NUM
1840	NUM
1842	NUM
1852	NUM
1857	NUM
1864	NUM
1874	NUM
1875	NUM
1877	NUM
1879	NUM
1880	NUM
1885	NUM
1886	NUM
1889	NUM
1890	NUM
19	NUM
1900	NUM
1969	NUM
1970	NUM
1974	NUM
1975	NUM
1979	NUM
1980	NUM
1983	NUM
1985	NUM
1991	NUM
1994	NUM
1997	NUM
1998	NUM
2	NUM
20	NUM
200	NUM
2000	NUM
2002	NUM
2003	NUM
2004	NUM
2005	NUM
2006	NUM
2007	NUM
2009	NUM
2011	NUM
2012	NUM
2013	NUM
209	NUM
21	NUM
24	NUM
25	NUM
250	NUM
27	NUM
29	NUM
3	NUM
30	NUM
300	NUM
3000	NUM
33453	NUM
34	NUM
36	NUM
40	NUM
43	NUM
44:28	NUM
5	NUM
5.30	NUM
50	NUM
500	NUM
50000	NUM
52	NUM
6	NUM
60	NUM
7	NUM
72438297502	NUM
7460352	NUM
8	NUM
814	NUM
9	NUM
900	NUM
95	NUM
:	PUNCT
;	PUNCT
<	PUNCT
<	SYM
>	PUNCT
?	PUNCT
A	PROPN
After	PROPN
Alan	PROPN
Associated	PROPN
Atmosphir	PROPN
Be	PROPN
Because	PROPN
Bengali	PROPN
Bhagavatgita	PROPN
Bharat	PROPN
Bibliotheca	PROPN
Bidde	PROPN
Billboard	PROPN
Blackberries	PROPN
Blackberry	PROPN
Brahmenian	PROPN
Brian	PROPN
Brothers	PROPN
Buddhica	PROPN
Bull	PROPN
Bötlingk	PROPN
CD	PROPN
CDP	PROPN
CK	PROPN
Cakuntala	PROPN
Calacoutta	PROPN
Calcutta	PROPN
Capitol	PROPN
Carlena	PROPN
Center	PROPN
Ch	PROPN
Chandra	PROPN
Cigar	PROPN
Columbia	PROPN
Concourse	PROPN
Country	PROPN
Crazy	PROPN
Danny	PROPN
Dark	PROPN
Design	PROPN
Dialects	PROPN
Diamond	PROPN
Dick	PROPN
Disguise	PROPN
Doctor	PROPN
Drooling	PROPN
Dropbox	PROPN
EMD	PROPN
EMI	PROPN
EMS	PROPN
Echoes	PROPN
Elementa	PROPN
Emily	PROPN
English	PROPN
Erskine	PROPN
Express	PROPN
FIA	PROPN
Fast	PROPN
Fi	PROPN
Fields	PROPN
Fitbit	PROPN
Floyd	PROPN
Geni	PROPN
George	PROPN
Golocknatdash	PROPN
Goodguide	PROPN
Gotta	PROPN
Grammar	PROPN
Grockit	PROPN
H.q	PROPN
Hardie	PROPN
Harvest	PROPN
Have	PROPN
Here	PROPN
Hi	PROPN
Hipgnosis	PROPN
Household	PROPN
Humphries	PROPN
I	PROPN
I	X
If	PROPN
Iphone	PROPN
Ipod	PROPN
It’s	PROPN
Jihn	PROPN
Johnston	PROPN
Jones	PROPN
L	PROPN
La	PROPN
Language	PROPN
Laughs	PROPN
Life	PROPN
Linux	PROPN
London	PROPN
Love	PROPN
Machine	PROPN
Madcap	PROPN
Maker	PROPN
Master	PROPN
Media	PROPN
Meghanad	PROPN
Melody	PROPN
Methodically	PROPN
Michelin	PROPN
Minor	PROPN
Moon	PROPN
More	PROPN
Music	PROPN
Musical	PROPN
Myspace	PROPN
New	PROPN
Nike	PROPN
Objects	PROPN
On	PROPN
PC	PROPN
PCQ	PROPN
Pali	PROPN
Parry	PROPN
Parsons	PROPN
Pete	PROPN
Petersbourg	PROPN
Pink	PROPN
Pitchfork	PROPN
Play	PROPN
Press	PROPN
Project	PROPN
Q	PROPN
Q4	PROPN
Rapports	PROPN
Rascasse	PROPN
Raving	PROPN
Ray	PROPN
Records	PROPN
Red	PROPN
Reuter	PROPN
Reuters	PROPN
Rogers	PROPN
Rolling	PROPN
Rondell	PROPN
Ronnie	PROPN
Roxy	PROPN
Russe	PROPN
S	PROPN
SAT	PROPN
SHVL	PROPN
Saha	PROPN
Sanscrit	PROPN
Sanskrit	PROPN
School	PROPN
See	PROPN
Shamscrit	PROPN
Shine	PROPN
Shore	PROPN
Shree	PROPN
Shundor	PROPN
Side	PROPN
Sir	PROPN
Society	PROPN
Stockmood	PROPN
Stone	PROPN
Studios	PROPN
Sundara	PROPN
Swype	PROPN
Syd	PROPN
System	PROPN
T9	PROPN
Techcrunch	PROPN
Techcrunch50	PROPN
Text	PROPN
The	PROPN
Today	PROPN
Tonchidot	PROPN
Twitter	PROPN
VCS	PROPN
Venetta	PROPN
Vidya	PROPN
W	PROPN
WDR	PROPN
Warcraft	PROPN
Warner	PROPN
Welcome	PROPN
Were	PROPN
Wilkins	PROPN
Williams	PROPN
Wish	PROPN
World	PROPN
Writtingpad	PROPN
Wörterbuch	PROPN
Yammer	PROPN
Year	PROPN
You	PROPN
[	PUNCT
]	PUNCT
a	X
about	X
according	X
achieves	X
actually	X
album	X
albums	X
all	X
an	X
and	X
approaches	X
aren’t	X
arranged	X
as	X
at	X
attracted	X
attractive	X
best	X
bit	X
both	X
brahmanicae	X
breaks	X
burned	X
but	X
by	X
call	X
can	X
close	X
comment	X
company	X
count	X
cried	X
critical	X
definitely	X
departments	X
dialect	X
dignity	X
direction	X
disappearance	X
displays	X
dramatic	X
e	NOUN
end	X
entre	X
et	X
favourite	X
felt	X
first	X
for	X
from	ADP
full	X
get	X
gravy	X
guitar	X
happily	X
hardly	X
has	X
have	X
he	PROPN
he	X
here	ADV
hitech	X
house	X
i	NUM
imagination	X
in	PROPN
in	X
indefinable	X
inevitable	X
is	X
it	X
its	X
jataka	X
la	X
lack	X
langue	X
left	X
like	X
listen	X
litteraturae	X
live	X
mail	X
many	X
me	X
melancholy	X
mixed	X
mostly	X
much	X
music	X
my	X
named	X
namely	X
not	X
obtained	X
of	X
oh	X
one	X
one’s	X
only	X
or	CCONJ
overflowing	X
pali	X
people	X
perform	X
permission	X
pieces	X
plays	X
pleasure	X
ponderous	X
ponderously	X
possible	X
pure	X
rail	X
really	X
representation	X
result	X
riding	X
round	X
sat	X
say	X
second	X
service	X
simple	X
simulated	X
sincerity	X
so	X
some	X
sort	X
sounds	X
staff	X
steel	X
still	X
stockmood.com	X
symphonic	X
synthesizer	X
talked	X
tamul	X
telugu	X
texture	X
that	X
the	PROPN
the	X
there	X
three	NUM
to	X
train	X
translated	X
two	NUM
unconvincing	X
used	X
very	X
wanted	X
was	X
wasn’t	X
way	X
we	PRON
we	X
what	X
whatever	X
which	X
whichever	X
with	X
would	X
xix	NUM
xv	NUM
xvii	NUM
xviii	NUM
£	PUNCT
£	SYM
«	PUNCT
»	PUNCT
е	ADJ
ю	ADJ
в	ADP
к	ADP
о	ADP
с	ADP
у	ADP
т	ADV
б	AUX
а	CCONJ
и	CCONJ
а	INTJ
о	INTJ
б	NOUN
в	NOUN
г	NOUN
л	NOUN
п	NOUN
т	NOUN
х	NUM
и	PART
н	PART
т	PRON
я	PRON
Д	PROPN
Е	PROPN
К	PROPN
М	PROPN
Р	PROPN
Ф	PROPN
–	PUNCT
—	PUNCT
…	PUNCT
№	SYM
а	X
в-третьих	ADV
С.	PROPN
с.ф	NOUN
А.к	PROPN
В.а	PROPN
В.п	PROPN
Г.С	PROPN
Г.с	PROPN
И.п	PROPN
Н.м	PROPN
С.Ф	PROPN
ф.и	PROPN
Т9	PROPN
во	ADP
до	ADP
за	ADP
из	ADP
на	ADP
от	ADP
по	ADP
бы	AUX
ни	CCONJ
но	CCONJ
ее	DET
их	DET
ах	INTJ
ну	NOUN
па	NOUN
ук	NOUN
ум	NOUN
ус	NOUN
бы	PART
да	PART
же	PART
жи	PART
ли	PART
не	PART
ни	PART
ну	PART
то	PART
уж	PART
вы	PRON
ей	PRON
мы	PRON
он	PRON
то	PRON
ты	PRON
Ан	PROPN
Би	PROPN
ЖЖ	PROPN
НУ	PROPN
РФ	PROPN
Си	PROPN
то	SCONJ
из-за	ADP
из-под	ADP
во-вторых	ADV
во-первых	ADV
др.	NOUN
сам	ADJ
без	ADP
вне	ADP
для	ADP
меж	ADP
над	ADP
под	ADP
при	ADP
про	ADP
где	ADV
еще	ADV
зза	ADV
как	ADV
так	ADV
там	ADV
тут	ADV
уже	ADV
или	CCONJ
ваш	DET
его	DET
мой	DET
наш	DET
сей	DET
тот	DET
чей	DET
ого	INTJ
бар	NOUN
бог	NOUN
бэк	NOUN
ваз	NOUN
веб	NOUN
век	NOUN
вес	NOUN
вид	NOUN
вод	NOUN
вуз	NOUN
год	NOUN
дом	NOUN
дух	NOUN
душ	NOUN
жой	NOUN
зал	NOUN
зуб	NOUN
имя	NOUN
лоб	NOUN
льв	NOUN
май	NOUN
меч	NOUN
мид	NOUN
мир	NOUN
муж	NOUN
нос	NOUN
ост	NOUN
пай	NOUN
пер	NOUN
пит	NOUN
пух	NOUN
раз	NOUN
рак	NOUN
род	NOUN
рок	NOUN
рот	NOUN
ряд	NOUN
сад	NOUN
сми	NOUN
смс	NOUN
сон	NOUN
суд	NOUN
тип	NOUN
тон	NOUN
тур	NOUN
ухо	NOUN
фон	NOUN
хан	NOUN
хит	NOUN
ход	NOUN
чай	NOUN
час	NOUN
чат	NOUN
шаг	NOUN
шок	NOUN
шоу	NOUN
шум	NOUN
эхо	NOUN
два	NUM
оба	NUM
сто	NUM
три	NUM
аль	PART
бен	PART
вот	PART
все	PART
нет	PART
это	PART
все	PRON
кто	PRON
нна	PRON
она	PRON
оне	PRON
они	PRON
оно	PRON
что	PRON
это	PRON
Аль	PROPN
Аня	PROPN
Бен	PROPN
Буш	PROPN
Газ	PROPN
Дас	PROPN
Дик	PROPN
Дюк	PROPN
Лос	PROPN
Мак	PROPN
Ман	PROPN
Нал	PROPN
Ник	PROPN
Пит	PROPN
РЭБ	PROPN
Рой	PROPN
СПБ	PROPN
США	PROPN
Сан	PROPN
Сид	PROPN
ФСБ	PROPN
Фил	PROPN
Юма	PROPN
как	SCONJ
раз	SCONJ
чем	SCONJ
что	SCONJ
нет	VERB
англ	ADJ
злой	ADJ
иной	ADJ
метр	ADJ
прав	ADJ
мимо	ADP
ради	ADP
боже	ADV
вряд	ADV
дома	ADV
едва	ADV
жаль	ADV
живо	ADV
куда	ADV
мало	ADV
надо	ADV
ныне	ADV
пока	ADV
рано	ADV
туда	ADV
хоть	ADV
чуть	ADV
явно	ADV
быть	AUX
зато	CCONJ
либо	CCONJ
весь	DET
один	DET
свой	DET
этот	DET
акад	NOUN
анал	NOUN
англ	NOUN
база	NOUN
банк	NOUN
бета	NOUN
блог	NOUN
боец	NOUN
боль	NOUN
брат	NOUN
бред	NOUN
вена	NOUN
вера	NOUN
верх	NOUN
вещь	NOUN
вина	NOUN
вино	NOUN
вода	NOUN
воин	NOUN
врач	NOUN
вред	NOUN
гимн	NOUN
глаз	NOUN
гонг	NOUN
гриб	NOUN
гром	NOUN
грот	NOUN
грош	NOUN
груз	NOUN
губа	NOUN
дама	NOUN
дань	NOUN
двор	NOUN
дело	NOUN
день	NOUN
диск	NOUN
долг	NOUN
дочь	NOUN
друг	NOUN
дура	NOUN
душа	NOUN
жена	NOUN
звук	NOUN
игра	NOUN
идея	NOUN
итог	NOUN
июль	NOUN
июнь	NOUN
кафе	NOUN
кино	NOUN
клуб	NOUN
кожа	NOUN
кола	NOUN
кофе	NOUN
круг	NOUN
курс	NOUN
куст	NOUN
куча	NOUN
лейн	NOUN
лето	NOUN
лист	NOUN
лифт	NOUN
лицо	NOUN
мама	NOUN
март	NOUN
мать	NOUN
мема	NOUN
мера	NOUN
метр	NOUN
мина	NOUN
море	NOUN
мост	NOUN
мрак	NOUN
мука	NOUN
небо	NOUN
нень	NOUN
нерв	NOUN
нога	NOUN
ночь	NOUN
нуль	NOUN
обед	NOUN
окно	NOUN
онна	NOUN
опыт	NOUN
орал	NOUN
очки	NOUN
паль	NOUN
парк	NOUN
перо	NOUN
план	NOUN
плод	NOUN
поле	NOUN
пора	NOUN
порт	NOUN
пост	NOUN
поэт	NOUN
проф	NOUN
путь	NOUN
пята	NOUN
рана	NOUN
раса	NOUN
рейс	NOUN
река	NOUN
речь	NOUN
риск	NOUN
роль	NOUN
роса	NOUN
рост	NOUN
рука	NOUN
руль	NOUN
сайт	NOUN
свет	NOUN
секс	NOUN
сеть	NOUN
сизо	NOUN
сила	NOUN
след	NOUN
слух	NOUN
смех	NOUN
соль	NOUN
срок	NOUN
стол	NOUN
суть	NOUN
счет	NOUN
тело	NOUN
тема	NOUN
тест	NOUN
титр	NOUN
трек	NOUN
труд	NOUN
удар	NOUN
ужас	NOUN
узда	NOUN
уран	NOUN
урод	NOUN
утро	NOUN
факт	NOUN
фото	NOUN
хлеб	NOUN
царь	NOUN
цвет	NOUN
цель	NOUN
цена	NOUN
цикл	NOUN
чарт	NOUN
часы	NOUN
чета	NOUN
член	NOUN
шина	NOUN
штаб	NOUN
щека	NOUN
эпос	NOUN
этаж	NOUN
этап	NOUN
этто	NOUN
этюд	NOUN
язык	NOUN
двое	NUM
один	NUM
пять	NUM
семь	NUM
трое	NUM
ведь	PART
даже	PART
зато	PART
либо	PART
лишь	PART
таки	PART
тоже	PART
хотя	PART
онна	PRON
себя	PRON
Агра	PROPN
Алан	PROPN
Анна	PROPN
Асад	PROPN
БПЛА	PROPN
Вакх	PROPN
Вера	PROPN
Влас	PROPN
Газа	PROPN
Гран	PROPN
Гугл	PROPN
ДНЯО	PROPN
Дели	PROPN
Делл	PROPN
Иван	PROPN
Ирак	PROPN
Иран	PROPN
Исуп	PROPN
Кант	PROPN
Кент	PROPN
Киев	PROPN
Кими	PROPN
Кинг	PROPN
Клиф	PROPN
Крым	PROPN
Леле	PROPN
Лели	PROPN
Лель	PROPN
Лена	PROPN
Марк	PROPN
Митя	PROPN
Моно	PROPN
Наук	PROPN
Ницш	PROPN
Норд	PROPN
ОБСЕ	PROPN
Олег	PROPN
Петр	PROPN
Пинк	PROPN
Райт	PROPN
Роуд	PROPN
Русь	PROPN
СССР	PROPN
Саиб	PROPN
Союз	PROPN
Хиль	PROPN
Холл	PROPN
Хуан	PROPN
Штат	PROPN
Эбби	PROPN
Юрий	PROPN
едва	SCONJ
если	SCONJ
хоть	SCONJ
хотя	SCONJ
бечь	VERB
бить	VERB
быть	VERB
дать	VERB
дуть	VERB
есть	VERB
жить	VERB
идти	VERB
лечь	VERB
ммой	VERB
мочь	VERB
петь	VERB
печь	VERB
пить	VERB
уйти	VERB
ввот	X
мало-помалу	ADV
белый	ADJ
вялый	ADJ
живой	ADJ
левый	ADJ
малый	ADJ
мамин	ADJ
милый	ADJ
ничей	ADJ
новый	ADJ
общий	ADJ
папин	ADJ
пятый	ADJ
русой	ADJ
самый	ADJ
седой	ADJ
серый	ADJ
синий	ADJ
сухой	ADJ
таков	ADJ
узкий	ADJ
умный	ADJ
холод	ADJ
худой	ADJ
целый	ADJ
яркий	ADJ
ясный	ADJ
ввиду	ADP
возле	ADP
вроде	ADP
кроме	ADP
между	ADP
около	ADP
перед	ADP
после	ADP
путем	ADP
среди	ADP
через	ADP
более	ADV
вверх	ADV
вдоль	ADV
везде	ADV
вкупе	ADV
вовсе	ADV
вроде	ADV
вслед	ADV
всюду	ADV
грубо	ADV
гулко	ADV
давно	ADV
далее	ADV
долго	ADV
домой	ADV
замуж	ADV
затем	ADV
зачем	ADV
здесь	ADV
иначе	ADV
когда	ADV
легко	ADV
лично	ADV
менее	ADV
много	ADV
можно	ADV
мягко	ADV
навек	ADV
назад	ADV
нежно	ADV
никак	ADV
нынче	ADV
опять	ADV
особо	ADV
очень	ADV
потом	ADV
почти	ADV
прямо	ADV
равно	ADV
разом	ADV
ранее	ADV
редко	ADV
резче	ADV
рядом	ADV
скоро	ADV
снова	ADV
сразу	ADV
столь	ADV
тайно	ADV
также	ADV
тесно	ADV
тогда	ADV
точно	ADV
часто	ADV
чинно	ADV
шумно	ADV
якобы	ADV
какой	DET
любой	DET
некий	DET
такой	DET
автор	NOUN
аллея	NOUN
алмаз	NOUN
альфа	NOUN
арена	NOUN
арест	NOUN
армия	NOUN
архив	NOUN
башня	NOUN
белье	NOUN
берег	NOUN
билет	NOUN
битва	NOUN
блеск	NOUN
бойец	NOUN
бокал	NOUN
болид	NOUN
бомба	NOUN
браво	NOUN
бровь	NOUN
брюка	NOUN
буква	NOUN
вдова	NOUN
ветвь	NOUN
ветер	NOUN
вечер	NOUN
вздох	NOUN
взлет	NOUN
взрыв	NOUN
видео	NOUN
визит	NOUN
вилка	NOUN
влага	NOUN
воина	NOUN
война	NOUN
вокал	NOUN
волна	NOUN
волос	NOUN
время	NOUN
вуаля	NOUN
вывод	NOUN
вызов	NOUN
гамма	NOUN
гараж	NOUN
глава	NOUN
голод	NOUN
голос	NOUN
гонка	NOUN
горло	NOUN
город	NOUN
гость	NOUN
гроза	NOUN
грудь	NOUN
густо	NOUN
дверь	NOUN
детка	NOUN
диван	NOUN
диття	NOUN
дочка	NOUN
драма	NOUN
дррук	NOUN
жизнь	NOUN
забор	NOUN
загар	NOUN
заказ	NOUN
закон	NOUN
запад	NOUN
запас	NOUN
запах	NOUN
звено	NOUN
земля	NOUN
идеал	NOUN
имидж	NOUN
индус	NOUN
ислам	NOUN
испуг	NOUN
исход	NOUN
казнь	NOUN
камин	NOUN
канал	NOUN
капля	NOUN
карта	NOUN
кисть	NOUN
клиша	NOUN
книга	NOUN
князь	NOUN
колея	NOUN
конец	NOUN
копия	NOUN
кровь	NOUN
крыша	NOUN
кузен	NOUN
кузин	NOUN
кукла	NOUN
кулак	NOUN
кулис	NOUN
купец	NOUN
кухня	NOUN
лакеи	NOUN
лакей	NOUN
лейбл	NOUN
лепка	NOUN
летта	NOUN
лидер	NOUN
линия	NOUN
ложка	NOUN
масло	NOUN
масса	NOUN
менты	NOUN
место	NOUN
месть	NOUN
месяц	NOUN
метод	NOUN
мечта	NOUN
мешок	NOUN
минет	NOUN
минус	NOUN
мотив	NOUN
мотор	NOUN
музей	NOUN
мусор	NOUN
мысль	NOUN
набор	NOUN
налет	NOUN
намек	NOUN
народ	NOUN
наука	NOUN
ножка	NOUN
номер	NOUN
нотка	NOUN
нужда	NOUN
обзор	NOUN
обида	NOUN
обмен	NOUN
образ	NOUN
обряд	NOUN
объем	NOUN
огонь	NOUN
озеро	NOUN
опера	NOUN
орган	NOUN
отбор	NOUN
ответ	NOUN
отдел	NOUN
отдых	NOUN
отель	NOUN
отзыв	NOUN
отказ	NOUN
отлив	NOUN
отрыв	NOUN
отчет	NOUN
очерк	NOUN
пакет	NOUN
палец	NOUN
парад	NOUN
парик	NOUN
пасть	NOUN
певец	NOUN
перст	NOUN
песня	NOUN
песок	NOUN
пилот	NOUN
пламя	NOUN
повар	NOUN
повод	NOUN
поиск	NOUN
полис	NOUN
помпа	NOUN
порог	NOUN
поток	NOUN
поэма	NOUN
право	NOUN
пресс	NOUN
проба	NOUN
профа	NOUN
пульт	NOUN
район	NOUN
рамка	NOUN
режим	NOUN
релиз	NOUN
рельс	NOUN
ролик	NOUN
рояль	NOUN
рубль	NOUN
рукка	NOUN
ручка	NOUN
рынок	NOUN
садко	NOUN
связь	NOUN
сезон	NOUN
семья	NOUN
серия	NOUN
сетка	NOUN
скала	NOUN
скрип	NOUN
скука	NOUN
скула	NOUN
слава	NOUN
слеза	NOUN
сленг	NOUN
слово	NOUN
смена	NOUN
смысл	NOUN
совет	NOUN
сосед	NOUN
сотня	NOUN
спрос	NOUN
среда	NOUN
старт	NOUN
стена	NOUN
стиль	NOUN
сторм	NOUN
страх	NOUN
судья	NOUN
сутки	NOUN
сушка	NOUN
сфера	NOUN
сцена	NOUN
тайна	NOUN
талон	NOUN
театр	NOUN
текст	NOUN
тетка	NOUN
тираж	NOUN
товар	NOUN
тоска	NOUN
траур	NOUN
треск	NOUN
тушка	NOUN
уклад	NOUN
успех	NOUN
устав	NOUN
факел	NOUN
фильм	NOUN
финал	NOUN
финиш	NOUN
форма	NOUN
фраза	NOUN
фронт	NOUN
хиппи	NOUN
цветы	NOUN
целое	NOUN
центр	NOUN
цыган	NOUN
часть	NOUN
чашка	NOUN
чепец	NOUN
черта	NOUN
честь	NOUN
число	NOUN
чулок	NOUN
шкала	NOUN
школа	NOUN
шорох	NOUN
шрифт	NOUN
штраф	NOUN
шурин	NOUN
экран	NOUN
эпопь	NOUN
эпоха	NOUN
юноша	NOUN
юрист	NOUN
ютьюб	NOUN
много	NUM
шесть	NUM
будто	PART
пусть	PART
разве	PART
также	PART
никто	PRON
ничто	PRON
Айман	PROPN
Алтай	PROPN
Байер	PROPN
Барак	PROPN
Башар	PROPN
Бирма	PROPN
Бихар	PROPN
Бруни	PROPN
Ганди	PROPN
Гилад	PROPN
Гомер	PROPN
Горно	PROPN
Декан	PROPN
Дэвид	PROPN
Дэнни	PROPN
Евсей	PROPN
Жанна	PROPN
Закон	PROPN
Ильич	PROPN
Индия	PROPN
Исаак	PROPN
Каида	PROPN
Корея	PROPN
Ладен	PROPN
Латиф	PROPN
Майкл	PROPN
Мамба	PROPN
Масса	PROPN
Мезак	PROPN
Могол	PROPN
Мусса	PROPN
Настя	PROPN
Наука	PROPN
Нация	PROPN
Непал	PROPN
Низам	PROPN
Обама	PROPN
Осама	PROPN
Пабло	PROPN
Павел	PROPN
Песня	PROPN
Пресс	PROPN
Путин	PROPN
Пэрри	PROPN
Расул	PROPN
Ронни	PROPN
Рунет	PROPN
Савва	PROPN
Салаф	PROPN
Салих	PROPN
Сатин	PROPN
Семен	PROPN
Сирия	PROPN
Совет	PROPN
София	PROPN
Софья	PROPN
Сторм	PROPN
Тагил	PROPN
Тагор	PROPN
Татуш	PROPN
Токио	PROPN
Тулси	PROPN
Филдс	PROPN
Флойд	PROPN
Хамас	PROPN
Харди	PROPN
Центр	PROPN
Чандр	PROPN
Чечня	PROPN
Шалит	PROPN
Шнель	PROPN
Эндрю	PROPN
будто	SCONJ
когда	SCONJ
пусть	SCONJ
чтобы	SCONJ
брать	VERB
везти	VERB
вести	VERB
войти	VERB
выйти	VERB
ехать	VERB
ждать	VERB
зайти	VERB
звать	VERB
знать	VERB
иметь	VERB
найти	VERB
подло	VERB
пойти	VERB
сесть	VERB
сжать	VERB
сиять	VERB
слать	VERB
снять	VERB
спеть	VERB
спить	VERB
стать	VERB
убить	VERB
уметь	VERB
эттот	X
адский	ADJ
алчный	ADJ
бедный	ADJ
боевой	ADJ
бойкий	ADJ
бывший	ADJ
важный	ADJ
верный	ADJ
видный	ADJ
второй	ADJ
высший	ADJ
глупый	ADJ
гордый	ADJ
грубый	ADJ
густой	ADJ
давний	ADJ
данный	ADJ
дивный	ADJ
добрый	ADJ
долгий	ADJ
должен	ADJ
другой	ADJ
дурной	ADJ
жадный	ADJ
жаркий	ADJ
желтый	ADJ
зимний	ADJ
зубной	ADJ
иссиза	ADJ
кислый	ADJ
легкий	ADJ
летний	ADJ
личный	ADJ
лишний	ADJ
ложный	ADJ
лунный	ADJ
лучший	ADJ
мелкий	ADJ
мокрый	ADJ
мудрый	ADJ
мягкий	ADJ
нежный	ADJ
низкий	ADJ
ночной	ADJ
нужный	ADJ
обуить	ADJ
особый	ADJ
острый	ADJ
парный	ADJ
первый	ADJ
плохой	ADJ
полный	ADJ
правый	ADJ
прочий	ADJ
прямой	ADJ
пустой	ADJ
пухлый	ADJ
равный	ADJ
разный	ADJ
ранний	ADJ
редкий	ADJ
робкий	ADJ
рослый	ADJ
свежий	ADJ
свиной	ADJ
слабый	ADJ
сладок	ADJ
слепой	ADJ
слышно	ADJ
смелый	ADJ
старый	ADJ
сужден	ADJ
схожий	ADJ
тайный	ADJ
темный	ADJ
тесный	ADJ
тонкий	ADJ
точный	ADJ
третий	ADJ
тяжкий	ADJ
тёмный	ADJ
убитый	ADJ
усатый	ADJ
уютный	ADJ
худший	ADJ
ценный	ADJ
черную	ADJ
черный	ADJ
чертый	ADJ
четкий	ADJ
чистый	ADJ
чуткий	ADJ
шумный	ADJ
эдакий	ADJ
вместо	ADP
поверх	ADP
помимо	ADP
прежде	ADP
против	ADP
сквозь	ADP
спустя	ADP
близко	ADV
больше	ADV
быстро	ADV
весело	ADV
весьма	ADV
вместе	ADV
вообще	ADV
вперед	ADV
вплоть	ADV
вполне	ADV
впрямь	ADV
всегда	ADV
вскоре	ADV
втайне	ADV
вчерра	ADV
высоко	ADV
громко	ADV
далеко	ADV
дважды	ADV
детски	ADV
дорого	ADV
завтра	ADV
заново	ADV
заодно	ADV
иногда	ADV
крайне	ADV
кстати	ADV
наголо	ADV
наряду	ADV
насилу	ADV
нельзя	ADV
нибудь	ADV
обычно	ADV
однако	ADV
откуда	ADV
отнюдь	ADV
отчего	ADV
поверх	ADV
поздно	ADV
потому	ADV
похоже	ADV
почему	ADV
правда	ADV
прежде	ADV
сверху	ADV
сейчас	ADV
сильно	ADV
скорее	ADV
совсем	ADV
сперва	ADV
срочно	ADV
строго	ADV
стыдно	ADV
сугубо	ADV
сходно	ADV
теперь	ADV
толком	ADV
тяжело	ADV
угодно	ADV
хорошо	ADV
широко	ADV
причем	CCONJ
всякий	DET
каждый	DET
Уотерс	NOUN
Часкор	NOUN
август	NOUN
альбом	NOUN
апатия	NOUN
апрель	NOUN
аромат	NOUN
артист	NOUN
аспект	NOUN
атеизм	NOUN
аффект	NOUN
балкон	NOUN
береза	NOUN
беседа	NOUN
бизнес	NOUN
блогер	NOUN
борьба	NOUN
боязнь	NOUN
бритва	NOUN
бронза	NOUN
брызга	NOUN
будуар	NOUN
буклет	NOUN
бумага	NOUN
былина	NOUN
ванная	NOUN
версия	NOUN
взгляд	NOUN
вихрем	NOUN
власть	NOUN
внучка	NOUN
воздух	NOUN
вопрос	NOUN
ворота	NOUN
вражда	NOUN
гаджет	NOUN
газета	NOUN
гибель	NOUN
гильза	NOUN
гитара	NOUN
гнездо	NOUN
голень	NOUN
голова	NOUN
гонщик	NOUN
горечь	NOUN
грабли	NOUN
группа	NOUN
грусть	NOUN
грядка	NOUN
данные	NOUN
девица	NOUN
делюкс	NOUN
деньги	NOUN
дерево	NOUN
деталь	NOUN
джихад	NOUN
дизайн	NOUN
диплом	NOUN
долина	NOUN
доллар	NOUN
доступ	NOUN
жалоба	NOUN
жертва	NOUN
житель	NOUN
журнал	NOUN
забота	NOUN
задача	NOUN
замена	NOUN
запись	NOUN
запрет	NOUN
застой	NOUN
защита	NOUN
звонок	NOUN
здание	NOUN
знание	NOUN
знаток	NOUN
золото	NOUN
именин	NOUN
индиец	NOUN
ирония	NOUN
камень	NOUN
капота	NOUN
каприз	NOUN
карета	NOUN
каскад	NOUN
кипсек	NOUN
кисело	NOUN
клипса	NOUN
кличка	NOUN
клубок	NOUN
кнауер	NOUN
княжна	NOUN
козырь	NOUN
колёсо	NOUN
кончик	NOUN
корень	NOUN
корсаж	NOUN
костюм	NOUN
кризис	NOUN
критик	NOUN
кромка	NOUN
кружок	NOUN
кузина	NOUN
ладонь	NOUN
ландыш	NOUN
ливень	NOUN
ливрей	NOUN
лирика	NOUN
листва	NOUN
личико	NOUN
логика	NOUN
лопата	NOUN
лошадь	NOUN
любовь	NOUN
манера	NOUN
машина	NOUN
ментор	NOUN
мечеть	NOUN
минута	NOUN
мнение	NOUN
могила	NOUN
модель	NOUN
молния	NOUN
молоко	NOUN
момент	NOUN
музыка	NOUN
мюзикл	NOUN
надзор	NOUN
наташа	NOUN
натуля	NOUN
нацизм	NOUN
начало	NOUN
неделя	NOUN
ноябрь	NOUN
нянька	NOUN
объект	NOUN
обычай	NOUN
одежда	NOUN
опушка	NOUN
орудие	NOUN
оружие	NOUN
основа	NOUN
отдача	NOUN
отзвук	NOUN
отклик	NOUN
отъезд	NOUN
ошибка	NOUN
пазуха	NOUN
память	NOUN
паника	NOUN
паркет	NOUN
партия	NOUN
паучок	NOUN
период	NOUN
печать	NOUN
пиджак	NOUN
письмо	NOUN
платок	NOUN
подиум	NOUN
подход	NOUN
помеха	NOUN
помощь	NOUN
портал	NOUN
правда	NOUN
предел	NOUN
предок	NOUN
премия	NOUN
пресса	NOUN
прибор	NOUN
призер	NOUN
прийти	NOUN
пример	NOUN
пробка	NOUN
проект	NOUN
пророк	NOUN
прыщик	NOUN
психоп	NOUN
птенец	NOUN
пустяк	NOUN
пьеска	NOUN
работа	NOUN
разбой	NOUN
раздел	NOUN
распад	NOUN
расчет	NOUN
регион	NOUN
резерв	NOUN
ресурс	NOUN
роджер	NOUN
руссок	NOUN
ручище	NOUN
связка	NOUN
секрет	NOUN
сектор	NOUN
секция	NOUN
сеньор	NOUN
сервер	NOUN
сервис	NOUN
сердце	NOUN
сессия	NOUN
сестра	NOUN
символ	NOUN
сирень	NOUN
сириец	NOUN
сказка	NOUN
сливки	NOUN
служба	NOUN
случай	NOUN
смерть	NOUN
снимок	NOUN
собрат	NOUN
солдат	NOUN
состав	NOUN
социал	NOUN
список	NOUN
способ	NOUN
ссылка	NOUN
стадия	NOUN
старик	NOUN
статья	NOUN
стерня	NOUN
стикер	NOUN
стилус	NOUN
стихия	NOUN
столик	NOUN
страна	NOUN
студия	NOUN
ступнь	NOUN
стычка	NOUN
стёкло	NOUN
судент	NOUN
судьба	NOUN
сумбур	NOUN
супруг	NOUN
талант	NOUN
творец	NOUN
теория	NOUN
тишина	NOUN
тысяча	NOUN
тюрьма	NOUN
уговор	NOUN
угроза	NOUN
улыбка	NOUN
умница	NOUN
упадок	NOUN
усилие	NOUN
услуга	NOUN
утрата	NOUN
ученик	NOUN
ученый	NOUN
фемиль	NOUN
фиалка	NOUN
фигура	NOUN
физика	NOUN
флакон	NOUN
формат	NOUN
фургон	NOUN
хозяин	NOUN
шерсть	NOUN
щетина	NOUN
экипаж	NOUN
эффект	NOUN
юбилей	NOUN
юность	NOUN
январь	NOUN
ярость	NOUN
восемь	NUM
двести	NUM
девять	NUM
десять	NUM
четыре	NUM
именно	PART
просто	PART
словно	PART
только	PART
нечего	PRON
нибудь	PRON
Абдель	PROPN
Агафон	PROPN
Адриан	PROPN
Алонсо	PROPN
Альбом	PROPN
Англия	PROPN
Банким	PROPN
Баррет	PROPN
Баффет	PROPN
Беслан	PROPN
Брайан	PROPN
Восток	PROPN
Гилмор	PROPN
Дарвин	PROPN
Джордж	PROPN
Долгов	PROPN
Донецк	PROPN
Европа	PROPN
Женева	PROPN
Зилоти	PROPN
Зилотя	PROPN
Иегуди	PROPN
Ирскин	PROPN
Кашлер	PROPN
Кнауэр	PROPN
Лондон	PROPN
МАГАТЭ	PROPN
Мадрас	PROPN
Марина	PROPN
Ментор	PROPN
Минаев	PROPN
Мишлен	PROPN
Монако	PROPN
Москва	PROPN
Мэйсон	PROPN
Наташа	PROPN
Ньютон	PROPN
Оккама	PROPN
Оксана	PROPN
Паллас	PROPN
Партия	PROPN
Полина	PROPN
Рамаян	PROPN
Рейтер	PROPN
Ричард	PROPN
Роберт	PROPN
Роджер	PROPN
Россия	PROPN
Сатина	PROPN
Сергей	PROPN
Сережа	PROPN
Скалоа	PROPN
Скалон	PROPN
Стефан	PROPN
Тартус	PROPN
Татуша	PROPN
Творец	PROPN
Тейлор	PROPN
Уваров	PROPN
Уоллес	PROPN
Уоррен	PROPN
Уотерс	PROPN
Уэббер	PROPN
Фелипе	PROPN
Харпер	PROPN
Цейлон	PROPN
Шлецер	PROPN
Эдуард	PROPN
Эрнест	PROPN
горный	PROPN
нежели	SCONJ
ахнуть	VERB
биться	VERB
брлать	VERB
бывать	VERB
ввести	VERB
видать	VERB
видеть	VERB
висеть	VERB
влиять	VERB
внести	VERB
водить	VERB
вылить	VERB
вязать	VERB
гореть	VERB
губить	VERB
давать	VERB
давить	VERB
делать	VERB
думать	VERB
дышать	VERB
жалеть	VERB
желать	VERB
забыть	VERB
задать	VERB
зажечь	VERB
занять	VERB
запить	VERB
играть	VERB
издать	VERB
искать	VERB
кануть	VERB
класть	VERB
купать	VERB
лежать	VERB
лечить	VERB
лишать	VERB
лишить	VERB
любить	VERB
менять	VERB
мешать	VERB
набить	VERB
навять	VERB
надеть	VERB
надуть	VERB
начать	VERB
неметь	VERB
носить	VERB
обойти	VERB
отбить	VERB
отдать	VERB
отлить	VERB
падать	VERB
палить	VERB
писать	VERB
побыть	VERB
подать	VERB
помочь	VERB
понять	VERB
прийти	VERB
пройти	VERB
решать	VERB
решить	VERB
сажать	VERB
свести	VERB
сидеть	VERB
скрыть	VERB
стоять	VERB
судить	VERB
счесть	VERB
съесть	VERB
сыпать	VERB
терять	VERB
убрать	VERB
увлечь	VERB
узнать	VERB
украть	VERB
успеть	VERB
устать	VERB
хотеть	VERB
цвести	VERB
цвесть	VERB
ценить	VERB
шутить	VERB
атомный	ADJ
бледный	ADJ
блеклый	ADJ
близкий	ADJ
богатый	ADJ
больший	ADJ
большой	ADJ
бранный	ADJ
будущий	ADJ
быстрый	ADJ
бытовой	ADJ
великий	ADJ
верхний	ADJ
веселый	ADJ
видимый	ADJ
вкусный	ADJ
влажный	ADJ
внешний	ADJ
военный	ADJ
высокий	ADJ
главный	ADJ
голубой	ADJ
горький	ADJ
горячий	ADJ
готовый	ADJ
далекий	ADJ
двойной	ADJ
девичий	ADJ
детская	ADJ
детский	ADJ
длинный	ADJ
должный	ADJ
дорогой	ADJ
древний	ADJ
древный	ADJ
дружный	ADJ
желчный	ADJ
женский	ADJ
зеленый	ADJ
злобный	ADJ
золотой	ADJ
игровой	ADJ
крайний	ADJ
красный	ADJ
краткий	ADJ
круглый	ADJ
крупный	ADJ
лаковый	ADJ
лиловый	ADJ
лукавый	ADJ
любимый	ADJ
матовый	ADJ
меньший	ADJ
местный	ADJ
мировой	ADJ
молодой	ADJ
наивный	ADJ
научный	ADJ
нелепый	ADJ
неясный	ADJ
обидный	ADJ
обычный	ADJ
опасный	ADJ
пищевой	ADJ
пожилой	ADJ
поздний	ADJ
похожий	ADJ
прежний	ADJ
простой	ADJ
прошлый	ADJ
путаный	ADJ
рабочий	ADJ
розовый	ADJ
русский	ADJ
садовый	ADJ
седьмой	ADJ
силовой	ADJ
сильный	ADJ
сложный	ADJ
смешной	ADJ
смуглый	ADJ
сотовый	ADJ
спорный	ADJ
средний	ADJ
старший	ADJ
строгий	ADJ
стыдный	ADJ
суровый	ADJ
сходный	ADJ
таковой	ADJ
текущий	ADJ
толстый	ADJ
трудный	ADJ
тяжелый	ADJ
угловой	ADJ
угодный	ADJ
ударный	ADJ
удобный	ADJ
ужасный	ADJ
хваткий	ADJ
хороший	ADJ
худобый	ADJ
царский	ADJ
частный	ADJ
честный	ADJ
широкий	ADJ
штатный	ADJ
ядерный	ADJ
активно	ADV
беготно	ADV
включая	ADV
впервые	ADV
впрочем	ADV
глубоко	ADV
гораздо	ADV
заметно	ADV
изжелта	ADV
конечно	ADV
красиво	ADV
ласково	ADV
мможжно	ADV
наверно	ADV
наконец	ADV
наотрез	ADV
начисто	ADV
недавно	ADV
недолго	ADV
немного	ADV
нередко	ADV
нечасто	ADV
никогда	ADV
однажды	ADV
пожалуй	ADV
поперек	ADV
пополам	ADV
поэтому	ADV
сегодня	ADV
сейчасс	ADV
скромно	ADV
слишком	ADV
сначала	ADV
солидно	ADV
столько	ADV
странно	ADV
страшно	ADV
хороший	ADV
никакой	DET
Господь	NOUN
авиация	NOUN
автобус	NOUN
адвокат	NOUN
алфавит	NOUN
аппарат	NOUN
аппетит	NOUN
арсенал	NOUN
асфальт	NOUN
афоризм	NOUN
бабушка	NOUN
барышня	NOUN
батюшка	NOUN
беседка	NOUN
бирочка	NOUN
блокада	NOUN
бригада	NOUN
буддизм	NOUN
будущее	NOUN
буйство	NOUN
вариант	NOUN
величие	NOUN
верочка	NOUN
влияние	NOUN
военный	NOUN
восторг	NOUN
вспышка	NOUN
встреча	NOUN
выплата	NOUN
гадость	NOUN
генерал	NOUN
генетик	NOUN
глубина	NOUN
головка	NOUN
гонорар	NOUN
горстка	NOUN
господь	NOUN
граница	NOUN
двойник	NOUN
девочка	NOUN
девушка	NOUN
декабрь	NOUN
депутат	NOUN
десяток	NOUN
детская	NOUN
детство	NOUN
деятель	NOUN
джатака	NOUN
диктант	NOUN
дисплей	NOUN
дневник	NOUN
дорожка	NOUN
дыхание	NOUN
дядюшка	NOUN
жалость	NOUN
желание	NOUN
женщина	NOUN
загадка	NOUN
задание	NOUN
задумка	NOUN
занятие	NOUN
записка	NOUN
запятка	NOUN
заслуга	NOUN
затылок	NOUN
зеркало	NOUN
зритель	NOUN
издание	NOUN
изножие	NOUN
империя	NOUN
импульс	NOUN
индолог	NOUN
инженер	NOUN
интерес	NOUN
испанец	NOUN
история	NOUN
кавалер	NOUN
калория	NOUN
капитал	NOUN
капюшон	NOUN
картина	NOUN
карьера	NOUN
катание	NOUN
кафедра	NOUN
клавиша	NOUN
классик	NOUN
клевета	NOUN
княгина	NOUN
княгиня	NOUN
кокетка	NOUN
коллега	NOUN
колокол	NOUN
колония	NOUN
команда	NOUN
комната	NOUN
конкурс	NOUN
контакт	NOUN
концерт	NOUN
конюшня	NOUN
корочка	NOUN
кошечка	NOUN
красота	NOUN
критика	NOUN
крыльцо	NOUN
купание	NOUN
кушанье	NOUN
линейка	NOUN
лишение	NOUN
ловушка	NOUN
магазин	NOUN
малость	NOUN
мальчик	NOUN
маршрут	NOUN
масштаб	NOUN
матушка	NOUN
мелодия	NOUN
милиция	NOUN
миллион	NOUN
милость	NOUN
минимум	NOUN
министр	NOUN
молодец	NOUN
москвич	NOUN
мужчина	NOUN
награда	NOUN
надежда	NOUN
напиток	NOUN
насилие	NOUN
находка	NOUN
неудача	NOUN
ниточка	NOUN
ннянька	NOUN
новинка	NOUN
новость	NOUN
ноктюрн	NOUN
нянюшка	NOUN
область	NOUN
обличье	NOUN
обложка	NOUN
образец	NOUN
общение	NOUN
октябрь	NOUN
оркестр	NOUN
отличие	NOUN
отрывок	NOUN
очередь	NOUN
падение	NOUN
паспорт	NOUN
педагог	NOUN
перевод	NOUN
переезд	NOUN
перерыв	NOUN
петтинг	NOUN
пианист	NOUN
пирожок	NOUN
планета	NOUN
поворот	NOUN
подпись	NOUN
подруга	NOUN
подушка	NOUN
подъезд	NOUN
позиция	NOUN
покупка	NOUN
полгода	NOUN
понятие	NOUN
попытка	NOUN
портрет	NOUN
порядок	NOUN
пособие	NOUN
постель	NOUN
похвала	NOUN
правило	NOUN
пракрит	NOUN
предмет	NOUN
привкус	NOUN
призрак	NOUN
принцип	NOUN
природа	NOUN
прихоть	NOUN
причина	NOUN
продажа	NOUN
продукт	NOUN
прокказ	NOUN
пропуск	NOUN
просьба	NOUN
процесс	NOUN
прошлое	NOUN
публика	NOUN
пустыня	NOUN
пылесос	NOUN
радикал	NOUN
радость	NOUN
рассказ	NOUN
реактор	NOUN
реакция	NOUN
ребенок	NOUN
религия	NOUN
реприза	NOUN
ресница	NOUN
решение	NOUN
росинка	NOUN
роскошь	NOUN
румянец	NOUN
русский	NOUN
самовар	NOUN
самолет	NOUN
свадьба	NOUN
свобода	NOUN
секунда	NOUN
серебро	NOUN
синолог	NOUN
сиротюк	NOUN
система	NOUN
складка	NOUN
скрипач	NOUN
словарь	NOUN
сметана	NOUN
соавтор	NOUN
собачка	NOUN
событие	NOUN
сонечка	NOUN
соринка	NOUN
спальня	NOUN
спасибо	NOUN
справка	NOUN
спутник	NOUN
стартап	NOUN
старший	NOUN
степень	NOUN
сторона	NOUN
страсть	NOUN
строчка	NOUN
студент	NOUN
сучочек	NOUN
счастье	NOUN
сюрприз	NOUN
тарелка	NOUN
телефон	NOUN
тетушка	NOUN
техника	NOUN
течение	NOUN
тиролец	NOUN
товарищ	NOUN
толкень	NOUN
топливо	NOUN
тренинг	NOUN
туннель	NOUN
тяжесть	NOUN
уровень	NOUN
усадьба	NOUN
условие	NOUN
участие	NOUN
учитель	NOUN
фаворит	NOUN
фактура	NOUN
фамилия	NOUN
флигель	NOUN
функция	NOUN
халифат	NOUN
хвостик	NOUN
хозяйка	NOUN
часишко	NOUN
частица	NOUN
человек	NOUN
чернила	NOUN
четверг	NOUN
чувство	NOUN
шапочка	NOUN
шахидка	NOUN
штиблет	NOUN
эйфория	NOUN
эксперт	NOUN
экспорт	NOUN
элемент	NOUN
эмбарго	NOUN
энергия	NOUN
юристка	NOUN
явление	NOUN
ярлычок	NOUN
полтора	NUM
пятьсот	NUM
сколько	NUM
шестеро	NUM
неужели	PART
который	PRON
Алексей	PROPN
Алтайск	PROPN
Альфред	PROPN
Америка	PROPN
Аполлон	PROPN
Барретт	PROPN
Баффетт	PROPN
Брагмен	PROPN
Ванечка	PROPN
Верочка	PROPN
Винетта	PROPN
Виталий	PROPN
Вотяков	PROPN
Герберт	PROPN
Горький	PROPN
Дмитрий	PROPN
Договор	PROPN
Израиль	PROPN
Карлина	PROPN
Карнеги	PROPN
Касимов	PROPN
Латакия	PROPN
Лебедев	PROPN
Ленинка	PROPN
Лысенко	PROPN
Магомет	PROPN
Менухин	PROPN
Мирзаев	PROPN
Миронов	PROPN
Михаэль	PROPN
Монтойе	PROPN
НАТАЛЬЯ	PROPN
Наталья	PROPN
Небворт	PROPN
Никитин	PROPN
Норфолк	PROPN
Парсонс	PROPN
Писарев	PROPN
Рамаяна	PROPN
Ригведа	PROPN
Роджерс	PROPN
Ронделл	PROPN
Румыния	PROPN
Сережей	PROPN
Сиротюк	PROPN
Сонечка	PROPN
Спенсер	PROPN
Толстой	PROPN
Тунечка	PROPN
Уильямс	PROPN
Украина	PROPN
Фейсбук	PROPN
Феррари	PROPN
Формула	PROPN
Франция	PROPN
Хамфрис	PROPN
Цуккина	PROPN
Шумахер	PROPN
Щедрина	PROPN
Эдмундс	PROPN
Эквадор	PROPN
аполлон	PROPN
римский	PROPN
бояться	VERB
браться	VERB
бродить	VERB
вводить	VERB
вдыхать	VERB
вложить	VERB
врыться	VERB
входить	VERB
въехать	VERB
выбрать	VERB
выбрить	VERB
выдрать	VERB
выехать	VERB
вызвать	VERB
вынести	VERB
вырасти	VERB
выучить	VERB
гладить	VERB
глядеть	VERB
гостеть	VERB
грозить	VERB
держать	VERB
достичь	VERB
дохнуть	VERB
дружить	VERB
забрать	VERB
завести	VERB
закрыть	VERB
засесть	VERB
заявить	VERB
звонить	VERB
звучать	VERB
изучать	VERB
изучить	VERB
иметься	VERB
корпеть	VERB
кричать	VERB
лизнуть	VERB
махнуть	VERB
мечтать	VERB
мчаться	VERB
набрать	VERB
навеять	VERB
назвать	VERB
найтись	VERB
обедать	VERB
обещать	VERB
обожать	VERB
обрести	VERB
обучить	VERB
одарить	VERB
оживать	VERB
оживить	VERB
ожидать	VERB
оказать	VERB
описать	VERB
освоить	VERB
осудить	VERB
отвлечь	VERB
отнести	VERB
отымать	VERB
оценить	VERB
перейти	VERB
плакать	VERB
платить	VERB
повезти	VERB
подлить	VERB
поднять	VERB
подойти	VERB
поедать	VERB
помнить	VERB
портить	VERB
постичь	VERB
править	VERB
предать	VERB
прибыть	VERB
прижать	VERB
принять	VERB
пробыть	VERB
продать	VERB
прожить	VERB
просить	VERB
протячь	VERB
пустить	VERB
пьянить	VERB
разбить	VERB
развить	VERB
сбежать	VERB
сбиться	VERB
связать	VERB
сгореть	VERB
сказать	VERB
скупать	VERB
скучать	VERB
скушать	VERB
следить	VERB
слиться	VERB
служить	VERB
слушать	VERB
слыхать	VERB
слышать	VERB
смутить	VERB
собрать	VERB
создать	VERB
спорить	VERB
ставить	VERB
строить	VERB
сходить	VERB
считать	VERB
тратить	VERB
трогать	VERB
убивать	VERB
уважать	VERB
увведди	VERB
уверить	VERB
уверять	VERB
уволить	VERB
ударить	VERB
удаться	VERB
уловить	VERB
умереть	VERB
унижать	VERB
уронить	VERB
урывать	VERB
усеться	VERB
усилить	VERB
усыпать	VERB
хвалить	VERB
хватать	VERB
хватить	VERB
хворать	VERB
хлюпать	VERB
чихнуть	VERB
явиться	VERB
активный	ADJ
арабский	ADJ
багряный	ADJ
безликий	ADJ
безумный	ADJ
былинный	ADJ
весенний	ADJ
вечерний	ADJ
взрослый	ADJ
виновный	ADJ
властный	ADJ
влекущий	ADJ
волоокий	ADJ
вопиющий	ADJ
гитарный	ADJ
глубокий	ADJ
грозовой	ADJ
денежный	ADJ
джазовый	ADJ
досадный	ADJ
дурацкий	ADJ
душистый	ADJ
жестокий	ADJ
забавный	ADJ
заказной	ADJ
закрытый	ADJ
звериный	ADJ
звуковой	ADJ
знакомый	ADJ
излишний	ADJ
именитый	ADJ
истинный	ADJ
июньский	ADJ
ключевой	ADJ
коварный	ADJ
комичный	ADJ
конечный	ADJ
короткий	ADJ
косматый	ADJ
красивый	ADJ
крымский	ADJ
лимонный	ADJ
любезный	ADJ
любовный	ADJ
малейший	ADJ
массовый	ADJ
махровый	ADJ
минувший	ADJ
надежный	ADJ
надобный	ADJ
народный	ADJ
неважный	ADJ
неверный	ADJ
недавний	ADJ
недолгий	ADJ
неловкий	ADJ
немецкий	ADJ
нынешний	ADJ
обратный	ADJ
обширный	ADJ
огромный	ADJ
основное	ADJ
основной	ADJ
отбивный	ADJ
отвесный	ADJ
открытый	ADJ
отличный	ADJ
пагубный	ADJ
парадный	ADJ
печатный	ADJ
повысить	ADJ
подобный	ADJ
понятный	ADJ
попутный	ADJ
премилый	ADJ
принятый	ADJ
приятный	ADJ
пытливый	ADJ
разумный	ADJ
районный	ADJ
реальный	ADJ
ревнивый	ADJ
росистый	ADJ
рыночный	ADJ
северный	ADJ
скорбный	ADJ
скромный	ADJ
соседний	ADJ
стальной	ADJ
странный	ADJ
страшный	ADJ
стройный	ADJ
судебный	ADJ
тверской	ADJ
торговый	ADJ
трудовой	ADJ
туманный	ADJ
тюремный	ADJ
успешный	ADJ
утренний	ADJ
холодный	ADJ
циничный	ADJ
цыплячий	ADJ
чудесный	ADJ
шелковый	ADJ
штрафной	ADJ
шутливый	ADJ
экранный	ADJ
языковой	ADJ
яростный	ADJ
согласно	ADP
банально	ADV
безмерно	ADV
внезапно	ADV
возможно	ADV
довольно	ADV
жизненно	ADV
заведомо	ADV
зачастую	ADV
искренне	ADV
морально	ADV
навсегда	ADV
наиболее	ADV
наоборот	ADV
например	ADV
напролом	ADV
напротив	ADV
нарочито	ADV
немножко	ADV
неслышно	ADV
несмотря	ADV
неудачно	ADV
особенно	ADV
отссюдда	ADV
подробно	ADV
поистине	ADV
поначалу	ADV
постыдно	ADV
радостно	ADV
свободно	ADV
сеегодня	ADV
серезный	ADV
серьезно	ADV
случайно	ADV
спокойно	ADV
тревожно	ADV
адюльтер	NOUN
академик	NOUN
активизм	NOUN
алгоритм	NOUN
алчность	NOUN
аналогия	NOUN
аниматор	NOUN
анимация	NOUN
аэропорт	NOUN
бальмонт	NOUN
бедность	NOUN
биология	NOUN
блюдечко	NOUN
богатырь	NOUN
болгарин	NOUN
болтовня	NOUN
больница	NOUN
братство	NOUN
буфетчик	NOUN
быстрота	NOUN
важность	NOUN
вакансия	NOUN
вариация	NOUN
введение	NOUN
вертолет	NOUN
взрослый	NOUN
владелец	NOUN
владение	NOUN
внимание	NOUN
вокалист	NOUN
волнение	NOUN
ворчанье	NOUN
выставка	NOUN
гипотеза	NOUN
глупость	NOUN
господин	NOUN
графство	NOUN
гребенка	NOUN
движение	NOUN
действие	NOUN
диапазон	NOUN
дизайнер	NOUN
динамика	NOUN
директор	NOUN
документ	NOUN
живопись	NOUN
животное	NOUN
жидкость	NOUN
закрытие	NOUN
заложник	NOUN
запчасть	NOUN
запястье	NOUN
зарплата	NOUN
здоровье	NOUN
знакомый	NOUN
значение	NOUN
идеалист	NOUN
известие	NOUN
изгородь	NOUN
излияние	NOUN
изучение	NOUN
инвестор	NOUN
интервью	NOUN
интернет	NOUN
инцидент	NOUN
исламист	NOUN
источник	NOUN
картинка	NOUN
каскадер	NOUN
кассация	NOUN
качество	NOUN
кисонька	NOUN
кладбище	NOUN
комиссия	NOUN
компания	NOUN
комплект	NOUN
контракт	NOUN
контроль	NOUN
конфликт	NOUN
критерий	NOUN
крокодил	NOUN
кротость	NOUN
крутизна	NOUN
культура	NOUN
ландшафт	NOUN
лепесток	NOUN
личность	NOUN
ловкость	NOUN
максимум	NOUN
материал	NOUN
мемориал	NOUN
менеджер	NOUN
механизм	NOUN
миллиард	NOUN
молчание	NOUN
мудрость	NOUN
музыкант	NOUN
название	NOUN
наркотик	NOUN
наследие	NOUN
насмешка	NOUN
нежность	NOUN
няннюшка	NOUN
обезьяна	NOUN
обещание	NOUN
обидчица	NOUN
обитание	NOUN
оболочка	NOUN
общество	NOUN
одеколон	NOUN
одурение	NOUN
оказание	NOUN
оператор	NOUN
оппонент	NOUN
оптимизм	NOUN
организм	NOUN
отбойник	NOUN
открытие	NOUN
отчаяние	NOUN
павильон	NOUN
памятник	NOUN
параметр	NOUN
парковка	NOUN
парнишка	NOUN
паутинка	NOUN
передача	NOUN
персонал	NOUN
писатель	NOUN
пистолет	NOUN
площадка	NOUN
плутоний	NOUN
поблажка	NOUN
подборка	NOUN
подножка	NOUN
подполье	NOUN
политика	NOUN
половина	NOUN
посланец	NOUN
послание	NOUN
поставка	NOUN
поступок	NOUN
похороны	NOUN
привычка	NOUN
приговор	NOUN
придумка	NOUN
приемная	NOUN
прилавок	NOUN
примочка	NOUN
принятие	NOUN
припадок	NOUN
приправа	NOUN
прищепка	NOUN
приятель	NOUN
проблема	NOUN
прогулка	NOUN
проделка	NOUN
продюсер	NOUN
прозвище	NOUN
проигрыш	NOUN
просмотр	NOUN
простыня	NOUN
прототип	NOUN
прохлада	NOUN
прощание	NOUN
работник	NOUN
разборка	NOUN
развитие	NOUN
разворот	NOUN
разговор	NOUN
различие	NOUN
растение	NOUN
ревность	NOUN
редактор	NOUN
репортаж	NOUN
ресепшен	NOUN
ресторан	NOUN
родитель	NOUN
рождение	NOUN
рукопись	NOUN
салафист	NOUN
санскрит	NOUN
сведение	NOUN
сентябрь	NOUN
середина	NOUN
симфония	NOUN
ситуация	NOUN
скорость	NOUN
слабость	NOUN
сладость	NOUN
смертник	NOUN
собрание	NOUN
согласие	NOUN
создание	NOUN
солнышко	NOUN
сомнение	NOUN
соннечка	NOUN
соцветие	NOUN
спальный	NOUN
средства	NOUN
средство	NOUN
старание	NOUN
старожил	NOUN
старость	NOUN
старушка	NOUN
стоккато	NOUN
столетие	NOUN
страница	NOUN
сумятица	NOUN
существо	NOUN
сущность	NOUN
творение	NOUN
теоретик	NOUN
торговля	NOUN
трубочка	NOUN
убийство	NOUN
уважение	NOUN
украинец	NOUN
упаковка	NOUN
усиление	NOUN
участник	NOUN
фантазия	NOUN
фигурант	NOUN
финалист	NOUN
фольклор	NOUN
фрагмент	NOUN
характер	NOUN
хождение	NOUN
цветение	NOUN
целлофан	NOUN
червячок	NOUN
черемуха	NOUN
четертый	NOUN
чиновник	NOUN
читатель	NOUN
эволюция	NOUN
экспромт	NOUN
эмигрант	NOUN
этажерка	NOUN
двадцать	NUM
тридцать	NUM
Агафонов	PROPN
Академия	PROPN
Анджелес	PROPN
Афанасий	PROPN
Болгария	PROPN
Васильев	PROPN
Владимир	PROPN
Вотякова	PROPN
Джонстон	PROPN
Евросоюз	PROPN
Завахири	PROPN
Ивановка	PROPN
Иммануил	PROPN
Институт	PROPN
Калидаса	PROPN
Калькутт	PROPN
Карамзин	PROPN
Киевский	PROPN
Корсаков	PROPN
Коссович	PROPN
Кристгау	PROPN
Култхард	PROPN
Лебедева	PROPN
Макларен	PROPN
Маллингс	PROPN
Мерседес	PROPN
Миссочка	PROPN
Наташина	PROPN
Одесский	PROPN
Павлович	PROPN
Павловна	PROPN
Пакистан	PROPN
Панфилов	PROPN
Приговор	PROPN
Раскассэ	PROPN
Сведение	PROPN
Северный	PROPN
Ситуация	PROPN
Спитфайр	PROPN
Тарышкин	PROPN
Толбузин	PROPN
Фернандо	PROPN
Фефелова	PROPN
Ширинкин	PROPN
западный	PROPN
миссочек	PROPN
блестеть	VERB
блистать	VERB
бороться	VERB
вдохнуть	VERB
веселить	VERB
включать	VERB
включить	VERB
вскипеть	VERB
вскочить	VERB
вставать	VERB
выбежать	VERB
выбирать	VERB
выезжать	VERB
выживать	VERB
выиграть	VERB
вылететь	VERB
вымирать	VERB
вынудить	VERB
выражать	VERB
выразить	VERB
вытекать	VERB
выходить	VERB
выяснить	VERB
говорить	VERB
готовить	VERB
грустить	VERB
даваться	VERB
даровать	VERB
дичиться	VERB
добавить	VERB
добиться	VERB
доводить	VERB
доходить	VERB
забиться	VERB
заболеть	VERB
заботить	VERB
забывать	VERB
завалить	VERB
задавать	VERB
зажимать	VERB
заказать	VERB
закинуть	VERB
заливать	VERB
заменить	VERB
заменять	VERB
замереть	VERB
заметать	VERB
заметить	VERB
замечать	VERB
замяться	VERB
занимать	VERB
записать	VERB
затекать	VERB
заточить	VERB
заходить	VERB
зацвести	VERB
зачесать	VERB
защитить	VERB
заявлять	VERB
избирать	VERB
изволить	VERB
издавать	VERB
изменить	VERB
измерить	VERB
испытать	VERB
истощить	VERB
казаться	VERB
катиться	VERB
кинуться	VERB
клеиться	VERB
миновать	VERB
навещать	VERB
навязать	VERB
надевать	VERB
наезжать	VERB
называть	VERB
наказать	VERB
наклеить	VERB
напирать	VERB
написать	VERB
напугать	VERB
нарушать	VERB
насажать	VERB
настоять	VERB
находить	VERB
нацелить	VERB
начаться	VERB
начинать	VERB
нашагать	VERB
нежиться	VERB
ночевать	VERB
обвинить	VERB
обвинять	VERB
обжигать	VERB
обклеить	VERB
облекать	VERB
обмануть	VERB
обновить	VERB
обойтись	VERB
обратить	VERB
обстоять	VERB
обшарить	VERB
общаться	VERB
объявить	VERB
овладеть	VERB
огорчить	VERB
означать	VERB
окружать	VERB
основать	VERB
оставить	VERB
остаться	VERB
отведать	VERB
ответить	VERB
отвечать	VERB
отдавать	VERB
отдалить	VERB
отдыхать	VERB
отложить	VERB
отменить	VERB
отметить	VERB
отмечать	VERB
отнимать	VERB
отослать	VERB
отражать	VERB
отразить	VERB
отрезать	VERB
отстоять	VERB
перебить	VERB
передать	VERB
печатать	VERB
побежать	VERB
поберечь	VERB
побывать	VERB
повалять	VERB
поверить	VERB
повлести	VERB
повысить	VERB
погодить	VERB
подавать	VERB
подрасти	VERB
подумать	VERB
пожимать	VERB
пожирать	VERB
показать	VERB
покинуть	VERB
покупать	VERB
полагать	VERB
получать	VERB
получить	VERB
полюбить	VERB
помогать	VERB
понимать	VERB
поощрить	VERB
попадать	VERB
поразить	VERB
порочить	VERB
посетить	VERB
посещать	VERB
посолить	VERB
посылать	VERB
потерять	VERB
поумнеть	VERB
похитить	VERB
привезти	VERB
привести	VERB
приехать	VERB
признать	VERB
прийтись	VERB
прикрыть	VERB
принести	VERB
присесть	VERB
прислать	VERB
провезти	VERB
провести	VERB
прогнать	VERB
прозвать	VERB
пропасть	VERB
прыснуть	VERB
пушиться	VERB
пытаться	VERB
работать	VERB
радовать	VERB
разучить	VERB
рисовать	VERB
сазаться	VERB
смеяться	VERB
смотреть	VERB
смягчать	VERB
снискать	VERB
соблюсти	VERB
соженный	VERB
сообщать	VERB
состоять	VERB
сочинить	VERB
спросить	VERB
стрелять	VERB
теряться	VERB
троггать	VERB
убеждать	VERB
увлекать	VERB
угрожать	VERB
удержать	VERB
украсить	VERB
украшать	VERB
умножать	VERB
упрощать	VERB
упускать	VERB
упустить	VERB
ускорять	VERB
успевать	VERB
устроить	VERB
уточнить	VERB
уточнять	VERB
хотеться	VERB
чудиться	VERB
являться	VERB
Соединить	ADJ
авторский	ADJ
азиатский	ADJ
алтайский	ADJ
анонимный	ADJ
ахиллесов	ADJ
бездушный	ADJ
белокурый	ADJ
ближайший	ADJ
бюджетный	ADJ
верховный	ADJ
виноватый	ADJ
внезапный	ADJ
возможный	ADJ
восточный	ADJ
годовалый	ADJ
голосовой	ADJ
горничный	ADJ
гороховый	ADJ
громадный	ADJ
довольный	ADJ
достойный	ADJ
доступный	ADJ
дружеский	ADJ
жизненный	ADJ
заглавный	ADJ
запретный	ADJ
заунывный	ADJ
известный	ADJ
индийский	ADJ
искренний	ADJ
исламский	ADJ
испанский	ADJ
казанский	ADJ
китайский	ADJ
курьезный	ADJ
латинский	ADJ
маленький	ADJ
маловатый	ADJ
мобильный	ADJ
моральный	ADJ
надзорный	ADJ
наивысший	ADJ
наилучший	ADJ
настоящий	ADJ
начальный	ADJ
небольшой	ADJ
недалекий	ADJ
некрупный	ADJ
неменьший	ADJ
необидный	ADJ
необычный	ADJ
несвязный	ADJ
неудачный	ADJ
неутешный	ADJ
низенький	ADJ
обязанный	ADJ
особенный	ADJ
остальной	ADJ
отдельный	ADJ
отцовский	ADJ
отчаянный	ADJ
очередной	ADJ
печальный	ADJ
подкидный	ADJ
поповский	ADJ
последний	ADJ
праведный	ADJ
привычный	ADJ
приличный	ADJ
приметный	ADJ
приторный	ADJ
причинный	ADJ
продажный	ADJ
противный	ADJ
протяжный	ADJ
публичный	ADJ
различный	ADJ
розоватый	ADJ
румынский	ADJ
свадебный	ADJ
свободный	ADJ
священный	ADJ
сенсорный	ADJ
сердечный	ADJ
серьезный	ADJ
сибирский	ADJ
синайский	ADJ
сиреневой	ADJ
сиреневый	ADJ
сирийский	ADJ
скованный	ADJ
следующий	ADJ
смешанный	ADJ
смешливый	ADJ
советский	ADJ
способный	ADJ
старинный	ADJ
стартовый	ADJ
столичный	ADJ
сторонний	ADJ
страховой	ADJ
стреляной	ADJ
студийный	ADJ
субботний	ADJ
сумрачный	ADJ
тактичный	ADJ
тогдашний	ADJ
топливный	ADJ
уверенный	ADJ
уголовный	ADJ
угреватый	ADJ
умеренный	ADJ
ухоженный	ADJ
финальный	ADJ
фруктовый	ADJ
четвертый	ADJ
чеченский	ADJ
благодаря	ADP
наподобие	ADP
абсолютно	ADV
аккуратно	ADV
беззвучно	ADV
бесплатно	ADV
бесцельно	ADV
буквально	ADV
ежедневно	ADV
заботливо	ADV
задумчиво	ADV
затейливо	ADV
зеркально	ADV
испуганно	ADV
мгновенно	ADV
насколько	ADV
настолько	ADV
негативно	ADV
незадолго	ADV
несколько	ADV
нисколько	ADV
образцово	ADV
осторожно	ADV
отдаленно	ADV
позитивно	ADV
полностью	ADV
поминутно	ADV
постоянно	ADV
правильно	ADV
удручающе	ADV
уединенно	ADV
участливо	ADV
физически	ADV
церемонно	ADV
некоторый	DET
авиабомба	NOUN
автономия	NOUN
агентство	NOUN
адаптация	NOUN
аллегория	NOUN
апелляция	NOUN
аппеляция	NOUN
атмосфера	NOUN
бизнесмен	NOUN
боеприпас	NOUN
бриллиант	NOUN
бухгалтер	NOUN
ведомство	NOUN
вечеринка	NOUN
включение	NOUN
внешность	NOUN
воззрение	NOUN
вольность	NOUN
выражение	NOUN
география	NOUN
грамматик	NOUN
громкость	NOUN
дарвинизм	NOUN
диковинка	NOUN
дразнилка	NOUN
журналист	NOUN
заведение	NOUN
заработок	NOUN
заседание	NOUN
заявление	NOUN
земляника	NOUN
изложение	NOUN
изменение	NOUN
император	NOUN
индология	NOUN
индустрия	NOUN
инноватор	NOUN
инспектор	NOUN
интонация	NOUN
искусство	NOUN
испытание	NOUN
истечение	NOUN
кафетерия	NOUN
княжество	NOUN
коллектив	NOUN
коллекция	NOUN
компьютер	NOUN
концепция	NOUN
коррупция	NOUN
красавица	NOUN
лапоткина	NOUN
любовница	NOUN
микроблог	NOUN
множество	NOUN
монастырь	NOUN
мороженое	NOUN
наказание	NOUN
намерение	NOUN
нападение	NOUN
написание	NOUN
нарушение	NOUN
настройка	NOUN
неясность	NOUN
новшество	NOUN
ныряльщик	NOUN
обвинение	NOUN
обитатель	NOUN
обобщение	NOUN
обожатель	NOUN
одуванчик	NOUN
окончание	NOUN
опасность	NOUN
оппозиция	NOUN
освещение	NOUN
основание	NOUN
отголосок	NOUN
отношение	NOUN
парламент	NOUN
переворот	NOUN
переписка	NOUN
пересадка	NOUN
пессимизм	NOUN
пластинка	NOUN
платформа	NOUN
племянник	NOUN
побережье	NOUN
поведение	NOUN
повышение	NOUN
поддержка	NOUN
подросток	NOUN
подсудима	NOUN
подушечки	NOUN
пожелание	NOUN
показание	NOUN
поколение	NOUN
покушение	NOUN
положение	NOUN
получение	NOUN
полушепот	NOUN
помещение	NOUN
попадание	NOUN
посещение	NOUN
посредник	NOUN
поставщик	NOUN
потенциал	NOUN
похищение	NOUN
появление	NOUN
правление	NOUN
правнучка	NOUN
преамбула	NOUN
президент	NOUN
презрение	NOUN
претензия	NOUN
признание	NOUN
провинция	NOUN
программа	NOUN
проповедь	NOUN
противник	NOUN
профессор	NOUN
пятилетие	NOUN
ревнивица	NOUN
революция	NOUN
регламент	NOUN
регулятор	NOUN
результат	NOUN
репертуар	NOUN
репутация	NOUN
россиянин	NOUN
саундтрек	NOUN
сверстник	NOUN
свидетель	NOUN
секретарь	NOUN
символика	NOUN
следствие	NOUN
слушатель	NOUN
сожаление	NOUN
создатель	NOUN
сообщение	NOUN
соперница	NOUN
состояние	NOUN
сотрудник	NOUN
спортсмен	NOUN
сторонник	NOUN
структура	NOUN
телевизор	NOUN
терроризм	NOUN
террорист	NOUN
торжество	NOUN
транспорт	NOUN
трудность	NOUN
тяготение	NOUN
увлечение	NOUN
удивление	NOUN
украшение	NOUN
улучшение	NOUN
умолчание	NOUN
универсум	NOUN
установка	NOUN
фестиваль	NOUN
филология	NOUN
философия	NOUN
церемония	NOUN
эквадорец	NOUN
экземпляр	NOUN
экономика	NOUN
несколько	NUM
Агентство	PROPN
Александр	PROPN
Астрахань	PROPN
Аурангзеб	PROPN
Валентина	PROPN
Васильева	PROPN
Граппелли	PROPN
Интерфакс	PROPN
Калькутта	PROPN
Лапоткина	PROPN
Латинский	PROPN
Ленинград	PROPN
Маленький	PROPN
Махабарат	PROPN
Михалкина	PROPN
Мосгорсуд	PROPN
Музенидис	PROPN
Николавна	PROPN
Палестина	PROPN
Петербург	PROPN
Райкконен	PROPN
Салтыкова	PROPN
Сергеевна	PROPN
Терентьев	PROPN
Торгерсон	PROPN
Третьяков	PROPN
Франциско	PROPN
Чаттерджи	PROPN
Шакунтала	PROPN
Ярославль	PROPN
жуковский	PROPN
президент	PROPN
поскольку	SCONJ
болтаться	VERB
бросаться	VERB
броситься	VERB
буксовать	VERB
вернуться	VERB
взглянуть	VERB
виднеться	VERB
возбудить	VERB
возникать	VERB
вообраззи	VERB
воплощать	VERB
восходить	VERB
вращаться	VERB
вспугнуть	VERB
вспыхнуть	VERB
встревать	VERB
встретить	VERB
втягивать	VERB
выглядеть	VERB
вымокнуть	VERB
выполнить	VERB
выполнять	VERB
выпустить	VERB
высказать	VERB
выставить	VERB
выступать	VERB
выступить	VERB
гнусавить	VERB
гордиться	VERB
грустнеть	VERB
держаться	VERB
диктовать	VERB
добраться	VERB
дозволить	VERB
допускать	VERB
допустить	VERB
дорваться	VERB
дослушать	VERB
забросить	VERB
завершить	VERB
завоевать	VERB
загружать	VERB
заключить	VERB
закончить	VERB
заполнить	VERB
запретить	VERB
запрещать	VERB
запускать	VERB
запустить	VERB
заставить	VERB
застучать	VERB
захватить	VERB
захлюпать	VERB
зашумлить	VERB
знакомить	VERB
избегнуть	VERB
извратить	VERB
изобрести	VERB
исключать	VERB
исполнить	VERB
исполнять	VERB
испортить	VERB
исчерпать	VERB
кончиться	VERB
наблюдать	VERB
наградить	VERB
надеяться	VERB
назначать	VERB
назначить	VERB
налипнуть	VERB
намекнуть	VERB
напомнить	VERB
направить	VERB
нарастить	VERB
настроить	VERB
наступить	VERB
нравиться	VERB
нуждаться	VERB
обижаться	VERB
обогатить	VERB
обсуждать	VERB
объяснять	VERB
оказаться	VERB
оказывать	VERB
окаймлять	VERB
опираться	VERB
описывать	VERB
оскорбить	VERB
отклонить	VERB
отнестись	VERB
отомстить	VERB
отправить	VERB
отпустить	VERB
отяготить	VERB
оценивать	VERB
перевести	VERB
переехать	VERB
перестать	VERB
поблажать	VERB
побояться	VERB
побранить	VERB
повернуть	VERB
повиснуть	VERB
повторить	VERB
погибнуть	VERB
погружать	VERB
подбивать	VERB
подбирать	VERB
поддавать	VERB
поддаться	VERB
поджигать	VERB
подкупать	VERB
подняться	VERB
подпадать	VERB
подписать	VERB
подражать	VERB
подрезать	VERB
подрывать	VERB
позволить	VERB
позволять	VERB
позвонить	VERB
поместить	VERB
пообещать	VERB
попастись	VERB
поправить	VERB
портиться	VERB
посвятить	VERB
поспевать	VERB
поступать	VERB
поступить	VERB
потерпеть	VERB
появиться	VERB
пребывать	VERB
превысить	VERB
предстать	VERB
прибавить	VERB
приезжать	VERB
приказать	VERB
приложить	VERB
применить	VERB
применять	VERB
принимать	VERB
приносить	VERB
приписать	VERB
присылать	VERB
приходить	VERB
прицепить	VERB
проверить	VERB
проводить	VERB
продавать	VERB
проживать	VERB
произойти	VERB
пролететь	VERB
проникать	VERB
пропитать	VERB
проситься	VERB
проторить	VERB
проходить	VERB
разбавить	VERB
развивать	VERB
развиться	VERB
разделить	VERB
разделять	VERB
размещать	VERB
расколоть	VERB
расписать	VERB
расцвести	VERB
расширить	VERB
ревновать	VERB
рождаться	VERB
связаться	VERB
следовать	VERB
случиться	VERB
сменяться	VERB
смириться	VERB
собраться	VERB
совершать	VERB
совершить	VERB
содержать	VERB
соединить	VERB
соединять	VERB
создавать	VERB
соскочить	VERB
сослаться	VERB
составить	VERB
сотрясать	VERB
сохранить	VERB
стараться	VERB
сходиться	VERB
тесниться	VERB
тормозить	VERB
требовать	VERB
трудиться	VERB
удалиться	VERB
удариться	VERB
удивиться	VERB
указывать	VERB
умолкнуть	VERB
упоминать	VERB
упомянуть	VERB
управлять	VERB
успокоить	VERB
устояться	VERB
усугубить	VERB
храниться	VERB
цепляться	VERB
куссоччек	X
автобусный	ADJ
адекватный	ADJ
аморальный	ADJ
английский	ADJ
бдительный	ADJ
беременный	ADJ
бесплатный	ADJ
британский	ADJ
буддийский	ADJ
ведический	ADJ
венгерский	ADJ
визуальный	ADJ
влюбленный	ADJ
глобальный	ADJ
господский	ADJ
дальнейший	ADJ
деликатный	ADJ
дерзостный	ADJ
джихадский	ADJ
долговязый	ADJ
домотканый	ADJ
ежедневный	ADJ
желтоватый	ADJ
затейливый	ADJ
знаменитый	ADJ
ивановский	ADJ
интересный	ADJ
кавказский	ADJ
каспийский	ADJ
каштановый	ADJ
комический	ADJ
концертный	ADJ
крамольный	ADJ
культурный	ADJ
купеческий	ADJ
лаконичный	ADJ
лондонский	ADJ
любопытный	ADJ
масштабный	ADJ
мгновенный	ADJ
миловидный	ADJ
могульский	ADJ
молчаливый	ADJ
московский	ADJ
мултанский	ADJ
навязчивый	ADJ
наибольший	ADJ
напористый	ADJ
насыщенный	ADJ
негативный	ADJ
незаконный	ADJ
незнакомый	ADJ
неизменный	ADJ
некрасивый	ADJ
нелюбезный	ADJ
немудреный	ADJ
неодолимый	ADJ
непомерный	ADJ
непонятный	ADJ
неприятный	ADJ
непрошеный	ADJ
несчастный	ADJ
неуместный	ADJ
образцовый	ADJ
огорченный	ADJ
онлайновый	ADJ
отдаленный	ADJ
пародийный	ADJ
персидский	ADJ
платиновый	ADJ
подходящий	ADJ
покороткий	ADJ
положенный	ADJ
полотняный	ADJ
популярный	ADJ
порывистый	ADJ
порядочный	ADJ
постоянный	ADJ
предыдущий	ADJ
прекрасный	ADJ
преступный	ADJ
прибыльный	ADJ
призванный	ADJ
приткнутый	ADJ
путеводный	ADJ
российский	ADJ
рукописный	ADJ
сессионный	ADJ
совместный	ADJ
социальный	ADJ
спортивный	ADJ
стеклянный	ADJ
стиральный	ADJ
телефонный	ADJ
трехмерный	ADJ
тщательный	ADJ
убежденный	ADJ
удручающий	ADJ
уединенный	ADJ
урожденный	ADJ
услужливый	ADJ
физический	ADJ
фиолетовый	ADJ
черненький	ADJ
шариатский	ADJ
шоколадный	ADJ
щербатский	ADJ
вследствие	ADP
достаточно	ADV
изначально	ADV
исподлобья	ADV
касательно	ADV
немедленно	ADV
неожиданно	ADV
неподвижно	ADV
несомненно	ADV
однозначно	ADV
осмысленно	ADV
постепенно	ADV
потихоньку	ADV
приветливо	ADV
разумеется	ADV
совершенно	ADV
специально	ADV
фактически	ADV
Кудрявский	NOUN
Ольденбург	NOUN
автомобиль	NOUN
активность	NOUN
американец	NOUN
англичанка	NOUN
артиллерия	NOUN
ассоциация	NOUN
барабанщик	NOUN
беспорядок	NOUN
библиотека	NOUN
боеголовка	NOUN
будущность	NOUN
варварство	NOUN
вокалистка	NOUN
вооружение	NOUN
воплощение	NOUN
восприятие	NOUN
вступление	NOUN
вязальщица	NOUN
грамматика	NOUN
губернатор	NOUN
губошлепие	NOUN
демократия	NOUN
добродушие	NOUN
достижение	NOUN
жительница	NOUN
загребание	NOUN
запрещение	NOUN
зарождение	NOUN
заступница	NOUN
знакомство	NOUN
извлечение	NOUN
инициатива	NOUN
инструкция	NOUN
инструмент	NOUN
информация	NOUN
исполнение	NOUN
киностудия	NOUN
клавиатура	NOUN
клеветница	NOUN
количество	NOUN
компиляция	NOUN
композиция	NOUN
контратака	NOUN
корпорация	NOUN
литература	NOUN
любезность	NOUN
меланхолия	NOUN
милиционер	NOUN
мироздание	NOUN
могущество	NOUN
моралистка	NOUN
назначение	NOUN
нарушитель	NOUN
настроение	NOUN
натуралист	NOUN
невинность	NOUN
недостаток	NOUN
нездоровье	NOUN
обермиллер	NOUN
облегчение	NOUN
обогащение	NOUN
обсуждение	NOUN
объявление	NOUN
объяснение	NOUN
органиация	NOUN
осмысление	NOUN
основатель	NOUN
отдыхающие	NOUN
отдыхающий	NOUN
отравление	NOUN
отсутствие	NOUN
отчуждение	NOUN
оформитель	NOUN
оформление	NOUN
очарование	NOUN
переговоры	NOUN
переоценка	NOUN
песельница	NOUN
победитель	NOUN
повторение	NOUN
подбородок	NOUN
подготовка	NOUN
подозрение	NOUN
подсудимая	NOUN
подчинение	NOUN
показатель	NOUN
полезность	NOUN
полномочие	NOUN
посетитель	NOUN
посольство	NOUN
постановка	NOUN
похождение	NOUN
правосудие	NOUN
преступник	NOUN
претендент	NOUN
приведение	NOUN
привилегия	NOUN
применение	NOUN
причинение	NOUN
протяжение	NOUN
проявление	NOUN
психопатка	NOUN
разлучница	NOUN
размещение	NOUN
разработка	NOUN
разрешение	NOUN
реальность	NOUN
ребячество	NOUN
республика	NOUN
самооценка	NOUN
свободовец	NOUN
секретарша	NOUN
синтезатор	NOUN
собиратель	NOUN
соглашение	NOUN
содержание	NOUN
созерцание	NOUN
сокращение	NOUN
солидность	NOUN
сообщество	NOUN
специалист	NOUN
статистика	NOUN
стремление	NOUN
творчество	NOUN
территория	NOUN
технология	NOUN
типография	NOUN
требование	NOUN
трудолюбие	NOUN
увеличение	NOUN
укрепление	NOUN
устранение	NOUN
учреждение	NOUN
фонограмма	NOUN
фотография	NOUN
хиндустань	NOUN
шампанское	NOUN
экспертиза	NOUN
экстремизм	NOUN
энергетика	NOUN
этнография	NOUN
пятнадцать	NUM
Афганистан	PROPN
Васильевич	PROPN
Дмитриевна	PROPN
Инструмент	PROPN
Калифорния	PROPN
Кудрявский	PROPN
Михайлович	PROPN
НИКОЛАЕВНА	PROPN
Николаевна	PROPN
Ольденбург	PROPN
Рахманинов	PROPN
Соглашение	PROPN
Степанович	PROPN
Тимофеевка	PROPN
Третьякова	PROPN
Фортунатов	PROPN
Хайдарабад	PROPN
Хитопадеша	PROPN
Чайковский	PROPN
Ярошевский	PROPN
рахманинов	PROPN
сохранение	PROPN
беспокоить	VERB
благоухать	VERB
бронзоветь	VERB
взбешенный	VERB
вздуматься	VERB
взорваться	VERB
влюбленный	VERB
воззилться	VERB
возникнуть	VERB
возрастать	VERB
вообразить	VERB
воротиться	VERB
восклицать	VERB
воспринять	VERB
вспоминать	VERB
вспомянуть	VERB
вспыхивать	VERB
выделывать	VERB
выказывать	VERB
выражаться	VERB
выставлять	VERB
вытереться	VERB
вытягивать	VERB
голосовать	VERB
готовиться	VERB
добираться	VERB
доставлять	VERB
жаловаться	VERB
заботиться	VERB
забрызгать	VERB
задаваться	VERB
задыхаться	VERB
заковылять	VERB
залежаться	VERB
залиловеть	VERB
заниматься	VERB
запенивать	VERB
записывать	VERB
заработать	VERB
засидеться	VERB
заставлять	VERB
застрелить	VERB
затянуться	VERB
избавиться	VERB
изготовить	VERB
измениться	VERB
изменяться	VERB
изображать	VERB
изобразить	VERB
изобретать	VERB
испытывать	VERB
колебаться	VERB
называться	VERB
наигрывать	VERB
наказывать	VERB
накопиться	VERB
напоминать	VERB
настаивать	VERB
натолкнуть	VERB
находиться	VERB
начинаться	VERB
обернуться	VERB
обеспечить	VERB
обжаловать	VERB
обрадовать	VERB
обратиться	VERB
обращаться	VERB
обременить	VERB
обсасывать	VERB
объединить	VERB
овладевать	VERB
ограничить	VERB
определить	VERB
опуститься	VERB
опустошить	VERB
освободить	VERB
оставаться	VERB
остановить	VERB
отвориться	VERB
отзываться	VERB
отказаться	VERB
относиться	VERB
отобразить	VERB
отозваться	VERB
отправвить	VERB
отразиться	VERB
очерченный	VERB
перебирать	VERB
переводить	VERB
переиздать	VERB
переходить	VERB
подвергать	VERB
поддержать	VERB
подскочить	VERB
показаться	VERB
полагаться	VERB
получаться	VERB
получиться	VERB
помириться	VERB
поставлять	VERB
пострадать	VERB
похвастать	VERB
появляться	VERB
превратить	VERB
предвидеть	VERB
предлагать	VERB
предложить	VERB
прекратить	VERB
привыкнуть	VERB
пригласить	VERB
приглашать	VERB
пригнуться	VERB
признавать	VERB
примолвить	VERB
приобрести	VERB
приоткрыть	VERB
приступить	VERB
пробуждать	VERB
продолжать	VERB
продолжить	VERB
произвести	VERB
произнести	VERB
проникнуть	VERB
проследить	VERB
прослушать	VERB
прошептать	VERB
радоваться	VERB
развлечься	VERB
раздвинуть	VERB
раздражать	VERB
разориться	VERB
разучивать	VERB
рассказать	VERB
рассуждать	VERB
руководить	VERB
сблизиться	VERB
скользнуть	VERB
скончаться	VERB
собираться	VERB
составлять	VERB
состояться	VERB
сострадать	VERB
справиться	VERB
спрашивать	VERB
сравнивать	VERB
стартовать	VERB
стесняться	VERB
стремиться	VERB
трактовать	VERB
увлекаться	VERB
улыбнуться	VERB
умудриться	VERB
установить	VERB
устаревший	VERB
утверждать	VERB
участиться	VERB
фальшивить	VERB
шокировать	VERB
штамповать	VERB
абстрактный	ADJ
агрессивный	ADJ
аналогичный	ADJ
аполитичный	ADJ
безупречный	ADJ
бенгальский	ADJ
бесконечный	ADJ
беспокойный	ADJ
бесстрашный	ADJ
благородный	ADJ
болезненный	ADJ
виртуальный	ADJ
вынужденный	ADJ
горьковатый	ADJ
гражданский	ADJ
двухдневный	ADJ
должностной	ADJ
достаточный	ADJ
драгоценный	ADJ
европейский	ADJ
захватистый	ADJ
злополучный	ADJ
израильский	ADJ
иностранный	ADJ
иронический	ADJ
контрактный	ADJ
конфликтный	ADJ
кристальный	ADJ
малахитовый	ADJ
миниатюрный	ADJ
мрачноватый	ADJ
музыкальный	ADJ
мучительный	ADJ
насмешливый	ADJ
насторожить	ADJ
натуральный	ADJ
невероятный	ADJ
невозможный	ADJ
невыносимый	ADJ
невыразимый	ADJ
незабвенный	ADJ
независимый	ADJ
необходимый	ADJ
неожиданный	ADJ
непослушный	ADJ
непременный	ADJ
неприличный	ADJ
несомненный	ADJ
общительный	ADJ
объективный	ADJ
огнеупорный	ADJ
однозначный	ADJ
октябрьский	ADJ
осмысленный	ADJ
официальный	ADJ
паралельный	ADJ
постепенный	ADJ
посторонний	ADJ
праздничный	ADJ
предержащий	ADJ
приветливый	ADJ
приземистый	ADJ
продвинутый	ADJ
психический	ADJ
радикальный	ADJ
разговорный	ADJ
религиозный	ADJ
решительный	ADJ
родственный	ADJ
саксофонный	ADJ
сексуальный	ADJ
сладковатый	ADJ
смертельный	ADJ
собственный	ADJ
совершенный	ADJ
современный	ADJ
соединенный	ADJ
специальный	ADJ
специфичный	ADJ
сценический	ADJ
талантливый	ADJ
телеграфный	ADJ
технический	ADJ
томительный	ADJ
трагический	ADJ
тырёхнотнть	ADJ
фактический	ADJ
французский	ADJ
характерный	ADJ
хрустальный	ADJ
черепаховый	ADJ
эгоистичный	ADJ
юридический	ADJ
посредством	ADP
безжалостно	ADV
внимательно	ADV
восторженно	ADV
естественно	ADV
значительно	ADV
обязательно	ADV
опредеенный	ADV
параллельно	ADV
практически	ADV
старательно	ADV
существенно	ADV
чрезвычайно	ADV
антрепренер	NOUN
ассортиметн	NOUN
балетоманка	NOUN
безработица	NOUN
беспилотник	NOUN
великолепие	NOUN
видеопортал	NOUN
возвращение	NOUN
воздействие	NOUN
возможность	NOUN
воображение	NOUN
впечатление	NOUN
выступление	NOUN
гендиректор	NOUN
голосование	NOUN
государство	NOUN
группировка	NOUN
гувернантка	NOUN
десятилетие	NOUN
диссертация	NOUN
достоинство	NOUN
журналистка	NOUN
заблуждение	NOUN
заболевание	NOUN
закрепление	NOUN
заместитель	NOUN
известность	NOUN
изнеможение	NOUN
изображение	NOUN
иллюстрация	NOUN
искренность	NOUN
комментарий	NOUN
коммивояжер	NOUN
конкуренция	NOUN
конференция	NOUN
лаборатория	NOUN
лингвистика	NOUN
мероприятие	NOUN
мусульманин	NOUN
награждение	NOUN
направление	NOUN
наслаждение	NOUN
обоснование	NOUN
образование	NOUN
обязанность	NOUN
ограничение	NOUN
одиночество	NOUN
определение	NOUN
организация	NOUN
оскорбление	NOUN
особенность	NOUN
оспаривание	NOUN
переиздание	NOUN
переложение	NOUN
переработка	NOUN
перестрелка	NOUN
перспектива	NOUN
подробность	NOUN
понедельник	NOUN
последствие	NOUN
поступление	NOUN
потерпевший	NOUN
предисловие	NOUN
предложение	NOUN
предприятие	NOUN
предыстория	NOUN
презентация	NOUN
прекращение	NOUN
препятствие	NOUN
преступница	NOUN
приглашение	NOUN
приключение	NOUN
приставание	NOUN
присутствие	NOUN
прокуратура	NOUN
просвещение	NOUN
путешествие	NOUN
развлечение	NOUN
размышление	NOUN
разоружение	NOUN
разработчик	NOUN
рассуждение	NOUN
ремастеринг	NOUN
ресторанчик	NOUN
родственник	NOUN
руководство	NOUN
рукопожатие	NOUN
серьезность	NOUN
сиятельство	NOUN
составление	NOUN
университет	NOUN
уничтожение	NOUN
утверждение	NOUN
ходатайство	NOUN
холодильник	NOUN
хулиганство	NOUN
языкознание	NOUN
единственно	PART
Артхашастра	PROPN
Атхарваведа	PROPN
Королевство	PROPN
Махабхарата	PROPN
Организация	PROPN
Панчатантра	PROPN
Хартфордшир	PROPN
Харьковский	PROPN
блокировать	VERB
взволновать	VERB
возглавлять	VERB
воодушевить	VERB
воспитывать	VERB
восхищаться	VERB
высказаться	VERB
высказывать	VERB
действовать	VERB
заканчивать	VERB
заключаться	VERB
закончиться	VERB
запаздывать	VERB
заслуживать	VERB
засчитывать	VERB
затрагивать	VERB
знакомиться	VERB
изобиловать	VERB
имитировать	VERB
исполниться	VERB
кокетничать	VERB
критиковать	VERB
меблировать	VERB
наклоняться	VERB
наполниться	VERB
напряженный	VERB
нарождаться	VERB
обостриться	VERB
обслуживать	VERB
объясниться	VERB
оказываться	VERB
оправдаться	VERB
опровергать	VERB
осложняться	VERB
отбрасывать	VERB
отклоняться	VERB
открываться	VERB
отправиться	VERB
планировать	VERB
повториться	VERB
погружаться	VERB
погрузиться	VERB
подвергнуть	VERB
подобраться	VERB
подозревать	VERB
подружиться	VERB
подтвердить	VERB
подчеркнуть	VERB
подчиняться	VERB
поздравлять	VERB
поморщиться	VERB
понравиться	VERB
попрощаться	VERB
послышаться	VERB
поссориться	VERB
постановить	VERB
праздновать	VERB
предаваться	VERB
предпринять	VERB
представить	VERB
прерываться	VERB
прибавиться	VERB
приговорить	VERB
применяться	VERB
припахивать	VERB
приподымать	VERB
приходиться	VERB
прищуриться	VERB
проговорить	VERB
прогуляться	VERB
продаваться	VERB
производить	VERB
происходить	VERB
протягивать	VERB
прошмыгнуть	VERB
развиваться	VERB
разобраться	VERB
разработать	VERB
растягивать	VERB
расходиться	VERB
расширяться	VERB
реализовать	VERB
свешиваться	VERB
сказываться	VERB
согласиться	VERB
содержаться	VERB
соединенный	VERB
создаваться	VERB
сокрушаться	VERB
сомневаться	VERB
сохраниться	VERB
справляться	VERB
становиться	VERB
столкнуться	VERB
сторониться	VERB
требоваться	VERB
третировать	VERB
увеличиться	VERB
удостоиться	VERB
упражняться	VERB
усиливаться	VERB
ускользнуть	VERB
усматривать	VERB
устраниться	VERB
участвовать	VERB
фиксировать	VERB
формировать	VERB
чувствовать	VERB
эпатировать	VERB
авторитетный	ADJ
акустический	ADJ
американский	ADJ
бетховенский	ADJ
венерический	ADJ
волонтерский	ADJ
высокоточный	ADJ
генетический	ADJ
дарвиновский	ADJ
дизайнерский	ADJ
дикорастущий	ADJ
долгожданный	ADJ
дравидийский	ADJ
единственный	ADJ
естественный	ADJ
змиеобразный	ADJ
значительный	ADJ
изумительный	ADJ
исламистский	ADJ
исторический	ADJ
кассационный	ADJ
классический	ADJ
коллективный	ADJ
компетентный	ADJ
краеугольный	ADJ
крестьянский	ADJ
материальный	ADJ
механический	ADJ
морщиноватый	ADJ
наркоманский	ADJ
национальный	ADJ
неинтересный	ADJ
немаловажный	ADJ
необузданный	ADJ
неотвратимый	ADJ
неположенный	ADJ
непослушшный	ADJ
непримиримый	ADJ
непрозрачный	ADJ
несдержанный	ADJ
неспортивный	ADJ
несравненный	ADJ
нестабильный	ADJ
новоявленный	ADJ
общественный	ADJ
определенный	ADJ
оригинальный	ADJ
пакистанский	ADJ
палестинский	ADJ
патетический	ADJ
первозданный	ADJ
политический	ADJ
почтительный	ADJ
прозаический	ADJ
региональный	ADJ
риторический	ADJ
салафистский	ADJ
санскритский	ADJ
сердоликовый	ADJ
следственный	ADJ
смехотворный	ADJ
старательный	ADJ
стихотворный	ADJ
студенческий	ADJ
существенный	ADJ
тематический	ADJ
традиционный	ADJ
транспортный	ADJ
убедительный	ADJ
удивительный	ADJ
укоризненный	ADJ
утомительный	ADJ
фортепианный	ADJ
христианский	ADJ
человеческий	ADJ
чрезвычайный	ADJ
эволюционный	ADJ
элементарный	ADJ
эмпирический	ADJ
беспрестанно	ADV
впоследствии	ADV
недостаточно	ADV
неоднозначно	ADV
неоднократно	ADV
одновременно	ADV
относительно	ADV
поразительно	ADV
революционно	ADV
самодовольно	ADV
стремительно	ADV
эмоционально	ADV
аплодисменты	NOUN
безопасность	NOUN
беременность	NOUN
беспокойство	NOUN
благоразумие	NOUN
бронетехника	NOUN
видеорассказ	NOUN
видеохостинг	NOUN
влюбленность	NOUN
деятельность	NOUN
еженедельник	NOUN
журналистика	NOUN
звукоинженер	NOUN
знаменитость	NOUN
изменчивость	NOUN
изобретатель	NOUN
исследование	NOUN
исчезновение	NOUN
квалификация	NOUN
коммуникация	NOUN
конфронтация	NOUN
легитимность	NOUN
маркирование	NOUN
микроблогинг	NOUN
многообразие	NOUN
недовольство	NOUN
неприятность	NOUN
новооткрытие	NOUN
обозреватель	NOUN
оборудование	NOUN
оппозиционер	NOUN
отрешённость	NOUN
первопричина	NOUN
передвижение	NOUN
пользователь	NOUN
популярность	NOUN
посещаемость	NOUN
правописание	NOUN
правопорядок	NOUN
празднование	NOUN
предвзятость	NOUN
предрассудок	NOUN
преимущество	NOUN
преступление	NOUN
преткновение	NOUN
приемлемость	NOUN
произведение	NOUN
производство	NOUN
происшествие	NOUN
пропагандист	NOUN
пространство	NOUN
профессионал	NOUN
психопатушка	NOUN
путеводитель	NOUN
радиостанция	NOUN
ранжирование	NOUN
распоряжение	NOUN
рассмотрение	NOUN
рекомендация	NOUN
сдержанность	NOUN
совокупность	NOUN
соответствие	NOUN
столкновение	NOUN
телефонистка	NOUN
товарищество	NOUN
удовольствие	NOUN
установление	NOUN
Ассоушиейтед	PROPN
Безопасность	PROPN
Богородицкий	PROPN
Журналистика	PROPN
Магнитогорск	PROPN
Политковская	PROPN
Психопатушка	PROPN
адаптировать	VERB
возобновлять	VERB
воспринимать	VERB
выговаривать	VERB
догадываться	VERB
доискиваться	VERB
задумываться	VERB
залеживаться	VERB
записываться	VERB
запоминаться	VERB
игнорировать	VERB
использовать	VERB
обеспечивать	VERB
обмениваться	VERB
обнаружиться	VERB
образовывать	VERB
одухотворить	VERB
опровергнуть	VERB
опубликовать	VERB
организовать	VERB
остановиться	VERB
отказываться	VERB
откликнуться	VERB
отправляться	VERB
парализовать	VERB
перекинуться	VERB
переписывать	VERB
переполошить	VERB
перепутаться	VERB
пересмотреть	VERB
поддерживать	VERB
подчеркивать	VERB
подчёркивать	VERB
покачиваться	VERB
пользоваться	VERB
понадобиться	VERB
превозносить	VERB
превратиться	VERB
предоставить	VERB
предположить	VERB
представлять	VERB
предупредить	VERB
преследовать	VERB
преуменьшать	VERB
приближаться	VERB
приблизиться	VERB
приглянуться	VERB
приключиться	VERB
принадлежать	VERB
приподняться	VERB
приравнивать	VERB
притворяться	VERB
проглатывать	VERB
продолжаться	VERB
проклюнуться	VERB
расползаться	VERB
распуститься	VERB
рассказывать	VERB
расследовать	VERB
рассчитывать	VERB
сопоставлять	VERB
сопровождать	VERB
сотрудничать	VERB
сталкиваться	VERB
существовать	VERB
финишировать	VERB
церемониться	VERB
автомобильный	ADJ
аналитический	ADJ
беспредметный	ADJ
бессмысленный	ADJ
благоприятный	ADJ
востоковедный	ADJ
всеобъемлющий	ADJ
всеукраинский	ADJ
двухкомнатный	ADJ
длинноволосый	ADJ
замечательный	ADJ
избирательный	ADJ
интерактивный	ADJ
искусственный	ADJ
испытательный	ADJ
ленинградский	ADJ
малоизвестный	ADJ
международный	ADJ
множественный	ADJ
неблагодарный	ADJ
незаконченный	ADJ
незаслуженный	ADJ
неоднозначный	ADJ
несовместимый	ADJ
неэффективный	ADJ
новоиндийский	ADJ
оглушительный	ADJ
основательный	ADJ
ответственный	ADJ
отечественный	ADJ
отрицательный	ADJ
петербургский	ADJ
показательный	ADJ
положительный	ADJ
правозащитный	ADJ
радиоактивный	ADJ
революционный	ADJ
самоуверенный	ADJ
симфонический	ADJ
сравнительный	ADJ
сыктывкарский	ADJ
торжественный	ADJ
увлекательный	ADJ
четырехручный	ADJ
четырёхнотный	ADJ
экологический	ADJ
экономический	ADJ
действительно	ADV
исключительно	ADV
необыкновенно	ADV
неубедительно	ADV
первоначально	ADV
подозрительно	ADV
целесообразно	ADV
администрация	NOUN
застенчивость	NOUN
звукоизоляция	NOUN
звукорежиссер	NOUN
интенсивность	NOUN
использование	NOUN
классификация	NOUN
консерватория	NOUN
корреспондент	NOUN
напряженность	NOUN
необходимость	NOUN
неожиданность	NOUN
неприличность	NOUN
обязательство	NOUN
однозначность	NOUN
популяризация	NOUN
последователь	NOUN
правительство	NOUN
правозащитник	NOUN
превознесение	NOUN
предположение	NOUN
представитель	NOUN
представление	NOUN
преподаватель	NOUN
присоединение	NOUN
производитель	NOUN
происхождение	NOUN
радиоприёмник	NOUN
разновидность	NOUN
разочарование	NOUN
расследование	NOUN
растерянность	NOUN
религиозность	NOUN
самовыражение	NOUN
свидетельство	NOUN
сопровождение	NOUN
сопротивление	NOUN
специальность	NOUN
существование	NOUN
хлебосольство	NOUN
Средневековье	PROPN
Троекуровский	PROPN
взбунтоваться	VERB
высказываться	VERB
гарантировать	VERB
завуалировать	VERB
задействовать	VERB
заканчиваться	VERB
инвестировать	VERB
конкурировать	VERB
нездоровиться	VERB
осуществиться	VERB
отсутствовать	VERB
перебарщивать	VERB
переоценивать	VERB
подействовать	VERB
подконтролить	VERB
подразумевать	VERB
поучаствовать	VERB
почувствовать	VERB
предназначить	VERB
предотвратить	VERB
предсказывать	VERB
представиться	VERB
предусмотреть	VERB
проголодаться	VERB
продребезжать	VERB
пролидировать	VERB
проскользнуть	VERB
противостоять	VERB
раздосадовать	VERB
рассматривать	VERB
расспрашивать	VERB
рекомендовать	VERB
странствовать	VERB
увеличиваться	VERB
удовлетворить	VERB
устанавливать	VERB
формулировать	VERB
воспитательный	ADJ
всепоглощающий	ADJ
грамматический	ADJ
дополнительный	ADJ
заключительный	ADJ
замоскворецкий	ADJ
идеологический	ADJ
индологический	ADJ
информационный	ADJ
консервативный	ADJ
легкомысленный	ADJ
малопосещаемый	ADJ
математический	ADJ
многочисленный	ADJ
незамысловатый	ADJ
незначительный	ADJ
некоммерческий	ADJ
неолиберальный	ADJ
неоформившийся	ADJ
непредвиденный	ADJ
несостоявшийся	ADJ
несуществующий	ADJ
новоиспеченный	ADJ
очаровательный	ADJ
первоначальный	ADJ
первостепенный	ADJ
подозрительный	ADJ
полиэтиленовый	ADJ
посредственный	ADJ
примечательный	ADJ
притягательный	ADJ
противоречивый	ADJ
процессуальный	ADJ
требовательный	ADJ
чувствительный	ADJ
экстремистский	ADJ
энергетический	ADJ
беспрекословно	ADV
самостоятельно	ADV
соответственно	ADV
вознаграждение	NOUN
востоковедение	NOUN
генеральшенька	NOUN
джентльменство	NOUN
договоренность	NOUN
какофоничность	NOUN
неосторожность	NOUN
обстоятельство	NOUN
общественность	NOUN
основоположник	NOUN
предотвращение	NOUN
преследователь	NOUN
провозглашение	NOUN
противоборство	NOUN
путешественник	NOUN
сентиментализм	NOUN
сочинительство	NOUN
справедливость	NOUN
электростанция	NOUN
Великобритания	PROPN
Генеральшенька	PROPN
Хайдерабадский	PROPN
адаптироваться	VERB
гастролировать	VERB
констатировать	VERB
контролировать	VERB
модифицировать	VERB
организовывать	VERB
осуществляться	VERB
переиздаваться	VERB
предполагаться	VERB
представляться	VERB
присоединиться	VERB
приспособиться	VERB
присутствовать	VERB
распространить	VERB
распространять	VERB
способствовать	VERB
антирелигиозный	ADJ
беспристрастный	ADJ
государственный	ADJ
дипломатический	ADJ
дореволюционный	ADJ
древнеиндийский	ADJ
затруднительный	ADJ
индоевропейский	ADJ
лингвистический	ADJ
межнациональный	ADJ
многодорожечный	ADJ
нереализованный	ADJ
образовательный	ADJ
привлекательный	ADJ
технологический	ADJ
франчайзинговый	ADJ
хронологический	ADJ
эксцентрический	ADJ
этнографический	ADJ
непосредственно	ADV
преимущественно	ADV
взаимоотношение	NOUN
злоупотребление	NOUN
мультимиллионер	NOUN
недостаточность	NOUN
ответственность	NOUN
предприниматель	NOUN
распространение	NOUN
безмолвствовать	VERB
демонстрировать	VERB
зарекомендовать	VERB
квалифицировать	VERB
модернизировать	VERB
останавливаться	VERB
поторапливаться	VERB
символизировать	VERB
соответствовать	VERB
фотографировать	VERB
характеризовать	VERB
заинтересованный	ADJ
инструментальный	ADJ
квадрафонический	ADJ
межкорпоративный	ADJ
непосредственный	ADJ
профессиональный	ADJ
разведывательный	ADJ
разоблачительный	ADJ
распространенный	ADJ
рекомендательный	ADJ
семнадцатилетний	ADJ
социалистический	ADJ
тринадцатилетний	ADJ
экстраординарный	ADJ
действительность	NOUN
наблюдательность	NOUN
наследственность	NOUN
невнимательность	NOUN
рассудительность	NOUN
самотестирование	NOUN
целесообразность	NOUN
электроснабжение	NOUN
Дашакумарачарита	PROPN
Рособоронэкспорт	PROPN
дистанцироваться	VERB
насамовольничать	VERB
преувеличиваться	VERB
распространяться	VERB
звукозаписывающий	ADJ
исследовательский	ADJ
правительственный	ADJ
преподавательский	ADJ
нераспространение	NOUN
продолжительность	NOUN
свидетельствовать	VERB
гипертрофированный	ADJ
двадцатидвухлетний	ADJ
двадцатисемилетний	ADJ
националистический	ADJ
правоохранительный	ADJ
последовательность	NOUN
усовершенствование	NOUN
вульгаризированный	VERB
противоборствовать	VERB
недискриминационный	ADJ
недофинансированный	ADJ
неправительственный	ADJ
переквалифицировать	VERB
революционизировать	VERB
высокотехнологический	ADJ
двадцатишестиминутный	ADJ
достопримечательность	NOUN
легковоспламеняющийся	VERB
